Barcode,Filename,Total,NoRadTag,LowQuality,Retained,Run,Removed,RunSeq
CTCG,S_20_00730,2564954,78819,646880,1839255,NS.1272.002.D701.Qilalugene-P1_detailed.log,725699,NS.1272.002
AGCG,S_20_00618,6207038,161521,1449425,4596092,NS.1272.002.D701.Qilalugene-P1_detailed.log,1610946,NS.1272.002
TTCTG,S_20_00778,5678544,20317,1407776,4250451,NS.1272.002.D701.Qilalugene-P1_detailed.log,1428093,NS.1272.002
ATTGA,S_20_00631,803394,35923,240034,527437,NS.1272.002.D701.Qilalugene-P1_detailed.log,275957,NS.1272.002
TCGTT,S_20_00786,1676830,7053,248805,1420972,NS.1272.002.D701.Qilalugene-P1_detailed.log,255858,NS.1272.002
GAGATA,S_20_00601,9683978,8696,2449039,7226243,NS.1272.002.D701.Qilalugene-P1_detailed.log,2457735,NS.1272.002
CTATTA,S_20_01215,2635834,9025,602138,2024671,NS.1272.002.D701.Qilalugene-P1_detailed.log,611163,NS.1272.002
CTTGCTT,S_20_00605,4213864,1165,1143003,3069696,NS.1272.002.D701.Qilalugene-P1_detailed.log,1144168,NS.1272.002
AATATGG,S_20_00607,4549398,11472,1381875,3156051,NS.1272.002.D701.Qilalugene-P1_detailed.log,1393347,NS.1272.002
GCGGAAT,S_20_00600,8275320,3029,2136600,6135691,NS.1272.002.D701.Qilalugene-P1_detailed.log,2139629,NS.1272.002
TGCAAGGA,S_20_00807,9294110,1175,2423791,6869144,NS.1272.002.D701.Qilalugene-P1_detailed.log,2424966,NS.1272.002
CCATGGGT,S_20_00662,7623906,11341,2089633,5522932,NS.1272.002.D701.Qilalugene-P1_detailed.log,2100974,NS.1272.002
TGCA,S_20_00732,2442380,248183,664916,1529281,NS.1272.002.D701.Qilalugene-P1_detailed.log,913099,NS.1272.002
GATG,S_20_01214,5142418,111519,1513721,3517178,NS.1272.002.D701.Qilalugene-P1_detailed.log,1625240,NS.1272.002
AGCCG,S_20_00901,3143508,15516,900169,2227823,NS.1272.002.D701.Qilalugene-P1_detailed.log,915685,NS.1272.002
CATCT,S_20_00805,4587772,37501,1351841,3198430,NS.1272.002.D701.Qilalugene-P1_detailed.log,1389342,NS.1272.002
GGTTGT,S_20_01217,1873410,4800,743719,1124891,NS.1272.002.D701.Qilalugene-P1_detailed.log,748519,NS.1272.002
ATGCCT,S_20_00625,10848948,7250,2665657,8176041,NS.1272.002.D701.Qilalugene-P1_detailed.log,2672907,NS.1272.002
GCCAGT,S_20_00769,7520368,9017,2706478,4804873,NS.1272.002.D701.Qilalugene-P1_detailed.log,2715495,NS.1272.002
ATGAAAG,S_20_03515,3616438,5454,1330314,2280670,NS.1272.002.D701.Qilalugene-P1_detailed.log,1335768,NS.1272.002
ACGTGTT,S_20_00800,4174394,5450,1322529,2846415,NS.1272.002.D701.Qilalugene-P1_detailed.log,1327979,NS.1272.002
TAGCGGA,S_20_00797,9711728,32425,2476399,7202904,NS.1272.002.D701.Qilalugene-P1_detailed.log,2508824,NS.1272.002
TGGTACGT,S_20_00703,3634838,977,1200011,2433850,NS.1272.002.D701.Qilalugene-P1_detailed.log,1200988,NS.1272.002
CGCGGAGA,S_20_03448,9346740,1640,2377040,6968060,NS.1272.002.D701.Qilalugene-P1_detailed.log,2378680,NS.1272.002
ACTA,S_20_00624,1190132,163258,287694,739180,NS.1272.002.D701.Qilalugene-P1_detailed.log,450952,NS.1272.002
TCAG,S_20_00626,3407320,55452,797778,2554090,NS.1272.002.D701.Qilalugene-P1_detailed.log,853230,NS.1272.002
GTATT,S_20_00670,5635390,12473,1548050,4074867,NS.1272.002.D701.Qilalugene-P1_detailed.log,1560523,NS.1272.002
CCTAG,S_20_00744,5402106,9508,1474638,3917960,NS.1272.002.D701.Qilalugene-P1_detailed.log,1484146,NS.1272.002
CCACGT,S_20_00767,2968300,17515,826463,2124322,NS.1272.002.D701.Qilalugene-P1_detailed.log,843978,NS.1272.002
AGTGGA,S_20_03522,7198472,19235,1947802,5231435,NS.1272.002.D701.Qilalugene-P1_detailed.log,1967037,NS.1272.002
GGAAGA,S_20_00671,1100216,3451,315810,780955,NS.1272.002.D701.Qilalugene-P1_detailed.log,319261,NS.1272.002
AAAAGTT,S_20_00699,9328126,49045,2576233,6702848,NS.1272.002.D701.Qilalugene-P1_detailed.log,2625278,NS.1272.002
ATTAATT,S_20_00606,7801944,7888,2128735,5665321,NS.1272.002.D701.Qilalugene-P1_detailed.log,2136623,NS.1272.002
TCGAAGA,S_20_03519,5418814,4086,1340669,4074059,NS.1272.002.D701.Qilalugene-P1_detailed.log,1344755,NS.1272.002
TCTCAGTG,S_20_00784,3186106,2299,1027401,2156406,NS.1272.002.D701.Qilalugene-P1_detailed.log,1029700,NS.1272.002
CGTGTGGT,S_20_00742,7428244,7443,1870518,5550283,NS.1272.002.D701.Qilalugene-P1_detailed.log,1877961,NS.1272.002
CAGA,S_20_00768,3796904,192735,988503,2615666,NS.1272.002.D701.Qilalugene-P1_detailed.log,1181238,NS.1272.002
TGCGA,S_20_00755,4040496,3119,1166261,2871116,NS.1272.002.D701.Qilalugene-P1_detailed.log,1169380,NS.1272.002
CTGTA,S_20_00741,3216120,10009,878215,2327896,NS.1272.002.D701.Qilalugene-P1_detailed.log,888224,NS.1272.002
GAGGA,S_20_00789,4312626,62110,1243614,3006902,NS.1272.002.D701.Qilalugene-P1_detailed.log,1305724,NS.1272.002
TTCAGA,S_20_00615,8528464,4029,2094411,6430024,NS.1272.002.D701.Qilalugene-P1_detailed.log,2098440,NS.1272.002
ACCTAA,S_20_00735,7791548,9080,2739848,5042620,NS.1272.002.D701.Qilalugene-P1_detailed.log,2748928,NS.1272.002
GTACTT,S_20_03517,6677930,7159,1865649,4805122,NS.1272.002.D701.Qilalugene-P1_detailed.log,1872808,NS.1272.002
GAATTCA,S_20_00811,9156902,6568,2588415,6561919,NS.1272.002.D701.Qilalugene-P1_detailed.log,2594983,NS.1272.002
ATTGGAT,S_20_00724,8419074,5947,2525018,5888109,NS.1272.002.D701.Qilalugene-P1_detailed.log,2530965,NS.1272.002
TCTGTGA,S_20_00806,2978114,443,1066162,1911509,NS.1272.002.D701.Qilalugene-P1_detailed.log,1066605,NS.1272.002
CGCGATAT,S_20_00665,3695548,954,913618,2780976,NS.1272.002.D701.Qilalugene-P1_detailed.log,914572,NS.1272.002
GCTGTGGA,S_20_00738,5301792,643,1474300,3826849,NS.1272.002.D701.Qilalugene-P1_detailed.log,1474943,NS.1272.002
AACT,S_20_00801,3541014,241128,828841,2471045,NS.1272.002.D701.Qilalugene-P1_detailed.log,1069969,NS.1272.002
CGCTT,S_20_00692,3065246,16171,768582,2280493,NS.1272.002.D701.Qilalugene-P1_detailed.log,784753,NS.1272.002
ACCGT,S_20_00622,12162690,34048,3229236,8899406,NS.1272.002.D701.Qilalugene-P1_detailed.log,3263284,NS.1272.002
GGAAG,S_20_03506,7321020,43144,1794358,5483518,NS.1272.002.D701.Qilalugene-P1_detailed.log,1837502,NS.1272.002
TAGGAA,S_20_01219,3556928,12405,745109,2799414,NS.1272.002.D701.Qilalugene-P1_detailed.log,757514,NS.1272.002
ATATGT,S_20_00604,9212286,26949,2503567,6681770,NS.1272.002.D701.Qilalugene-P1_detailed.log,2530516,NS.1272.002
GTTGAA,S_20_03452,8197718,1730,2239621,5956367,NS.1272.002.D701.Qilalugene-P1_detailed.log,2241351,NS.1272.002
GAACTTG,S_20_01221,3502002,14243,765004,2722755,NS.1272.002.D701.Qilalugene-P1_detailed.log,779247,NS.1272.002
CATAAGT,S_20_00725,9339378,5514,2972223,6361641,NS.1272.002.D701.Qilalugene-P1_detailed.log,2977737,NS.1272.002
TGCTGGA,S_20_00666,9410294,903,2640300,6769091,NS.1272.002.D701.Qilalugene-P1_detailed.log,2641203,NS.1272.002
CGCCTTAT,S_20_00765,4263832,1759,1115262,3146811,NS.1272.002.D701.Qilalugene-P1_detailed.log,1117021,NS.1272.002
GGATTGGT,S_20_00718,9521592,3203,2610341,6908048,NS.1272.002.D701.Qilalugene-P1_detailed.log,2613544,NS.1272.002
GCGT,S_20_00721,2044598,62194,572182,1410222,NS.1272.002.D701.Qilalugene-P1_detailed.log,634376,NS.1272.002
TCACG,S_20_00623,1259094,13867,353559,891668,NS.1272.002.D701.Qilalugene-P1_detailed.log,367426,NS.1272.002
GCTTA,S_20_00712,5110472,8862,1423264,3678346,NS.1272.002.D701.Qilalugene-P1_detailed.log,1432126,NS.1272.002
GTCAA,S_20_00804,6220450,26672,1511939,4681839,NS.1272.002.D701.Qilalugene-P1_detailed.log,1538611,NS.1272.002
GCTCTA,S_20_00780,5448732,3920,1429582,4015230,NS.1272.002.D701.Qilalugene-P1_detailed.log,1433502,NS.1272.002
ATCGTA,S_20_00729,8743086,13146,3281095,5448845,NS.1272.002.D701.Qilalugene-P1_detailed.log,3294241,NS.1272.002
TAACGA,S_20_00792,8435988,34831,2117564,6283593,NS.1272.002.D701.Qilalugene-P1_detailed.log,2152395,NS.1272.002
GGACCTA,S_20_03510,1990168,1081,715681,1273406,NS.1272.002.D701.Qilalugene-P1_detailed.log,716762,NS.1272.002
CGCTGAT,S_20_00757,4223366,2970,1265758,2954638,NS.1272.002.D701.Qilalugene-P1_detailed.log,1268728,NS.1272.002
ACGACTAG,S_20_03514,8442446,6440,2216228,6219778,NS.1272.002.D701.Qilalugene-P1_detailed.log,2222668,NS.1272.002
AACCGAGA,S_20_00663,1310618,2093,413104,895421,NS.1272.002.D701.Qilalugene-P1_detailed.log,415197,NS.1272.002
GTGAGGGT,S_20_00667,11595632,5288,2996050,8594294,NS.1272.002.D701.Qilalugene-P1_detailed.log,3001338,NS.1272.002
CGAT,S_20_00803,4697440,184411,1088838,3424191,NS.1272.002.D701.Qilalugene-P1_detailed.log,1273249,NS.1272.002
CTAGG,S_20_00754,8041736,33114,2632835,5375787,NS.1272.002.D701.Qilalugene-P1_detailed.log,2665949,NS.1272.002
GGTGT,S_20_00630,5928982,15023,1502705,4411254,NS.1272.002.D701.Qilalugene-P1_detailed.log,1517728,NS.1272.002
TAATA,S_20_00802,4788678,56327,1359883,3372468,NS.1272.002.D701.Qilalugene-P1_detailed.log,1416210,NS.1272.002
CCACAA,S_20_00749,9796502,21107,2821268,6954127,NS.1272.002.D701.Qilalugene-P1_detailed.log,2842375,NS.1272.002
CATCGT,S_20_00621,2151490,11162,584827,1555501,NS.1272.002.D701.Qilalugene-P1_detailed.log,595989,NS.1272.002
TGGCTA,S_20_00717,3485018,6615,1260626,2217777,NS.1272.002.D701.Qilalugene-P1_detailed.log,1267241,NS.1272.002
GTCGATT,S_20_00701,8205402,2652,2118755,6083995,NS.1272.002.D701.Qilalugene-P1_detailed.log,2121407,NS.1272.002
CGGTAGA,S_20_01218,1552302,623,423319,1128360,NS.1272.002.D701.Qilalugene-P1_detailed.log,423942,NS.1272.002
TAGCATGG,S_20_01216,3015664,2961,679614,2333089,NS.1272.002.D701.Qilalugene-P1_detailed.log,682575,NS.1272.002
ACAGGGA,S_20_00790,5781342,7136,1544771,4229435,NS.1272.002.D701.Qilalugene-P1_detailed.log,1551907,NS.1272.002
TATCGGGA,S_20_00762,11444878,11328,3275529,8158021,NS.1272.002.D701.Qilalugene-P1_detailed.log,3286857,NS.1272.002
GTAA,S_20_00700,1256716,178990,260062,817664,NS.1272.002.D701.Qilalugene-P1_detailed.log,439052,NS.1272.002
ACAAA,S_20_00653,7010896,179789,1854588,4976519,NS.1272.002.D701.Qilalugene-P1_detailed.log,2034377,NS.1272.002
AGGAT,S_20_00720,7173300,25118,1760777,5387405,NS.1272.002.D701.Qilalugene-P1_detailed.log,1785895,NS.1272.002
TACAT,S_20_00781,4030450,79277,1009600,2941573,NS.1272.002.D701.Qilalugene-P1_detailed.log,1088877,NS.1272.002
CTTCCA,S_20_00779,8076342,8055,1929866,6138421,NS.1272.002.D701.Qilalugene-P1_detailed.log,1937921,NS.1272.002
CGCGGT,S_20_00616,9936644,5773,2421445,7509426,NS.1272.002.D701.Qilalugene-P1_detailed.log,2427218,NS.1272.002
TATTTTT,S_20_00743,4477778,4806,1373515,3099457,NS.1272.002.D701.Qilalugene-P1_detailed.log,1378321,NS.1272.002
AACGCCT,S_20_03524,11183738,6432,3023963,8153343,NS.1272.002.D701.Qilalugene-P1_detailed.log,3030395,NS.1272.002
CTACGGA,S_20_00697,2954048,2571,820355,2131122,NS.1272.002.D701.Qilalugene-P1_detailed.log,822926,NS.1272.002
TAGGCCAT,S_20_00719,11236302,3169,3416058,7817075,NS.1272.002.D701.Qilalugene-P1_detailed.log,3419227,NS.1272.002
ACGTGGTA,S_20_00652,6088266,3590,1997251,4087425,NS.1272.002.D701.Qilalugene-P1_detailed.log,2000841,NS.1272.002
TTCCTGGA,S_20_03446,16245416,11239,4443894,11790283,NS.1272.002.D701.Qilalugene-P1_detailed.log,4455133,NS.1272.002
CTCG,S_20_00734,2368944,98083,751997,1518864,NS.1272.002.D702.Qilalugene-P2_detailed.log,850080,NS.1272.002
AGCG,S_20_01032,6013934,129339,1870011,4014584,NS.1272.002.D702.Qilalugene-P2_detailed.log,1999350,NS.1272.002
TTCTG,S_20_03511,472394,17173,154945,300276,NS.1272.002.D702.Qilalugene-P2_detailed.log,172118,NS.1272.002
ATTGA,S_20_00783,602950,29282,201865,371803,NS.1272.002.D702.Qilalugene-P2_detailed.log,231147,NS.1272.002
TCGTT,S_20_00766,7181070,16087,2214010,4950973,NS.1272.002.D702.Qilalugene-P2_detailed.log,2230097,NS.1272.002
GAGATA,S_20_00775,4429646,5336,1451997,2972313,NS.1272.002.D702.Qilalugene-P2_detailed.log,1457333,NS.1272.002
CTATTA,S_20_00731,3248976,9126,1187515,2052335,NS.1272.002.D702.Qilalugene-P2_detailed.log,1196641,NS.1272.002
CTTGCTT,S_20_03509,4184908,1199,1415421,2768288,NS.1272.002.D702.Qilalugene-P2_detailed.log,1416620,NS.1272.002
AATATGG,S_20_00753,8340378,15326,3057592,5267460,NS.1272.002.D702.Qilalugene-P2_detailed.log,3072918,NS.1272.002
GCGGAAT,S_20_03521,8490784,3427,2558957,5928400,NS.1272.002.D702.Qilalugene-P2_detailed.log,2562384,NS.1272.002
TGCAAGGA,S_20_03512,5557562,636,1718948,3837978,NS.1272.002.D702.Qilalugene-P2_detailed.log,1719584,NS.1272.002
CCATGGGT,S_20_00726,9488286,12171,2907692,6568423,NS.1272.002.D702.Qilalugene-P2_detailed.log,2919863,NS.1272.002
TGCA,S_20_00752,1797418,236427,672949,888042,NS.1272.002.D702.Qilalugene-P2_detailed.log,909376,NS.1272.002
GATG,S_20_00690,2527332,114690,826624,1586018,NS.1272.002.D702.Qilalugene-P2_detailed.log,941314,NS.1272.002
AGCCG,S_20_00809,6953818,22030,2213525,4718263,NS.1272.002.D702.Qilalugene-P2_detailed.log,2235555,NS.1272.002
CATCT,S_20_00608,6866484,40367,2268857,4557260,NS.1272.002.D702.Qilalugene-P2_detailed.log,2309224,NS.1272.002
GGTTGT,S_20_00602,8596984,5879,2925061,5666044,NS.1272.002.D702.Qilalugene-P2_detailed.log,2930940,NS.1272.002
ATGCCT,S_20_03516,5189854,4495,1899637,3285722,NS.1272.002.D702.Qilalugene-P2_detailed.log,1904132,NS.1272.002
GCCAGT,S_20_01213,10936922,9702,3191130,7736090,NS.1272.002.D702.Qilalugene-P2_detailed.log,3200832,NS.1272.002
ATGAAAG,S_20_00709,4363192,7233,1663263,2692696,NS.1272.002.D702.Qilalugene-P2_detailed.log,1670496,NS.1272.002
ACGTGTT,S_20_00713,2403556,7411,910781,1485364,NS.1272.002.D702.Qilalugene-P2_detailed.log,918192,NS.1272.002
TAGCGGA,S_20_00776,5148698,16887,1601463,3530348,NS.1272.002.D702.Qilalugene-P2_detailed.log,1618350,NS.1272.002
TGGTACGT,S_20_03505,1198638,447,569657,628534,NS.1272.002.D702.Qilalugene-P2_detailed.log,570104,NS.1272.002
CGCGGAGA,S_20_01222,4382182,1432,1261392,3119358,NS.1272.002.D702.Qilalugene-P2_detailed.log,1262824,NS.1272.002
ACTA,S_20_00614,2730564,182225,842546,1705793,NS.1272.002.D702.Qilalugene-P2_detailed.log,1024771,NS.1272.002
TCAG,S_20_00619,898904,68922,318128,511854,NS.1272.002.D702.Qilalugene-P2_detailed.log,387050,NS.1272.002
GTATT,S_20_03449,7730774,13348,2415983,5301443,NS.1272.002.D702.Qilalugene-P2_detailed.log,2429331,NS.1272.002
CCTAG,S_20_00772,8188986,14292,2526229,5648465,NS.1272.002.D702.Qilalugene-P2_detailed.log,2540521,NS.1272.002
CCACGT,S_20_00698,96574,29784,22918,43872,NS.1272.002.D702.Qilalugene-P2_detailed.log,52702,NS.1272.002
AGTGGA,S_20_00610,7832292,5073,2493866,5333353,NS.1272.002.D702.Qilalugene-P2_detailed.log,2498939,NS.1272.002
GGAAGA,S_20_03454,9282522,2219,2814035,6466268,NS.1272.002.D702.Qilalugene-P2_detailed.log,2816254,NS.1272.002
AAAAGTT,S_20_00694,720978,46395,224883,449700,NS.1272.002.D702.Qilalugene-P2_detailed.log,271278,NS.1272.002
ATTAATT,S_20_00722,4004464,5308,1395379,2603777,NS.1272.002.D702.Qilalugene-P2_detailed.log,1400687,NS.1272.002
TCGAAGA,S_20_00758,11165528,7837,4072974,7084717,NS.1272.002.D702.Qilalugene-P2_detailed.log,4080811,NS.1272.002
TCTCAGTG,S_20_00733,3606404,2264,1530160,2073980,NS.1272.002.D702.Qilalugene-P2_detailed.log,1532424,NS.1272.002
CGTGTGGT,S_20_00810,5063846,5335,1613260,3445251,NS.1272.002.D702.Qilalugene-P2_detailed.log,1618595,NS.1272.002
CAGA,S_20_01144,5187136,234558,1476266,3476312,NS.1272.002.D702.Qilalugene-P2_detailed.log,1710824,NS.1272.002
TGCGA,S_20_00799,5628808,2541,1650336,3975931,NS.1272.002.D702.Qilalugene-P2_detailed.log,1652877,NS.1272.002
CTGTA,S_20_00629,6033202,13034,1881331,4138837,NS.1272.002.D702.Qilalugene-P2_detailed.log,1894365,NS.1272.002
GAGGA,S_20_00702,1646860,65442,546265,1035153,NS.1272.002.D702.Qilalugene-P2_detailed.log,611707,NS.1272.002
TTCAGA,S_20_03451,12473856,5275,3802539,8666042,NS.1272.002.D702.Qilalugene-P2_detailed.log,3807814,NS.1272.002
ACCTAA,S_20_00740,9338702,11063,2854750,6472889,NS.1272.002.D702.Qilalugene-P2_detailed.log,2865813,NS.1272.002
GTACTT,S_20_01220,2157128,4852,577017,1575259,NS.1272.002.D702.Qilalugene-P2_detailed.log,581869,NS.1272.002
GAATTCA,S_20_00664,4689710,4437,1705065,2980208,NS.1272.002.D702.Qilalugene-P2_detailed.log,1709502,NS.1272.002
ATTGGAT,S_20_00691,1762982,4040,576410,1182532,NS.1272.002.D702.Qilalugene-P2_detailed.log,580450,NS.1272.002
TCTGTGA,S_20_00609,5005840,529,1589123,3416188,NS.1272.002.D702.Qilalugene-P2_detailed.log,1589652,NS.1272.002
CGCGATAT,S_20_00668,1533980,563,504474,1028943,NS.1272.002.D702.Qilalugene-P2_detailed.log,505037,NS.1272.002
GCTGTGGA,S_20_00627,3650290,510,1174868,2474912,NS.1272.002.D702.Qilalugene-P2_detailed.log,1175378,NS.1272.002
AACT,S_20_03447,4367408,271718,1200705,2894985,NS.1272.002.D702.Qilalugene-P2_detailed.log,1472423,NS.1272.002
CGCTT,S_20_00793,6895970,25977,2043565,4826428,NS.1272.002.D702.Qilalugene-P2_detailed.log,2069542,NS.1272.002
ACCGT,S_20_00785,203702,32666,61302,109734,NS.1272.002.D702.Qilalugene-P2_detailed.log,93968,NS.1272.002
GGAAG,S_20_00693,1468326,60499,486447,921380,NS.1272.002.D702.Qilalugene-P2_detailed.log,546946,NS.1272.002
TAGGAA,S_20_03507,11867102,13896,3953104,7900102,NS.1272.002.D702.Qilalugene-P2_detailed.log,3967000,NS.1272.002
ATATGT,S_20_03652,9342346,29764,2945526,6367056,NS.1272.002.D702.Qilalugene-P2_detailed.log,2975290,NS.1272.002
GTTGAA,S_20_00808,12008038,2268,3570493,8435277,NS.1272.002.D702.Qilalugene-P2_detailed.log,3572761,NS.1272.002
GAACTTG,S_20_00632,4866298,14226,1532056,3320016,NS.1272.002.D702.Qilalugene-P2_detailed.log,1546282,NS.1272.002
CATAAGT,S_20_03455,12773710,7146,4040771,8725793,NS.1272.002.D702.Qilalugene-P2_detailed.log,4047917,NS.1272.002
TGCTGGA,S_20_03450,15131874,1162,4560763,10569949,NS.1272.002.D702.Qilalugene-P2_detailed.log,4561925,NS.1272.002
CGCCTTAT,S_20_00695,7833738,3250,2515014,5315474,NS.1272.002.D702.Qilalugene-P2_detailed.log,2518264,NS.1272.002
GGATTGGT,S_20_00711,7702936,3669,2808399,4890868,NS.1272.002.D702.Qilalugene-P2_detailed.log,2812068,NS.1272.002
GCGT,S_20_00751,5490922,76935,1675979,3738008,NS.1272.002.D702.Qilalugene-P2_detailed.log,1752914,NS.1272.002
TCACG,S_20_00761,9464670,22286,3085794,6356590,NS.1272.002.D702.Qilalugene-P2_detailed.log,3108080,NS.1272.002
GCTTA,S_20_00904,6914332,13719,2421543,4479070,NS.1272.002.D702.Qilalugene-P2_detailed.log,2435262,NS.1272.002
GTCAA,S_20_00660,2572548,29145,840601,1702802,NS.1272.002.D702.Qilalugene-P2_detailed.log,869746,NS.1272.002
GCTCTA,S_20_00661,3561902,3211,1218793,2339898,NS.1272.002.D702.Qilalugene-P2_detailed.log,1222004,NS.1272.002
ATCGTA,S_20_00777,4886948,8996,1702894,3175058,NS.1272.002.D702.Qilalugene-P2_detailed.log,1711890,NS.1272.002
TAACGA,S_20_03453,9035436,34065,3085296,5916075,NS.1272.002.D702.Qilalugene-P2_detailed.log,3119361,NS.1272.002
GGACCTA,S_20_00669,1415984,911,500198,914875,NS.1272.002.D702.Qilalugene-P2_detailed.log,501109,NS.1272.002
CGCTGAT,S_20_00788,9100074,4936,2683019,6412119,NS.1272.002.D702.Qilalugene-P2_detailed.log,2687955,NS.1272.002
ACGACTAG,S_20_00750,6089124,4614,2198412,3886098,NS.1272.002.D702.Qilalugene-P2_detailed.log,2203026,NS.1272.002
AACCGAGA,S_20_00771,13018690,12366,4050205,8956119,NS.1272.002.D702.Qilalugene-P2_detailed.log,4062571,NS.1272.002
GTGAGGGT,S_20_00603,10066328,4456,2959256,7102616,NS.1272.002.D702.Qilalugene-P2_detailed.log,2963712,NS.1272.002
CGAT,S_20_00628,5129644,219004,1457198,3453442,NS.1272.002.D702.Qilalugene-P2_detailed.log,1676202,NS.1272.002
CTAGG,S_20_00796,11628116,36564,3481414,8110138,NS.1272.002.D702.Qilalugene-P2_detailed.log,3517978,NS.1272.002
GGTGT,S_20_00770,7753650,13572,2520167,5219911,NS.1272.002.D702.Qilalugene-P2_detailed.log,2533739,NS.1272.002
TAATA,S_20_01223,4988282,73383,1659199,3255700,NS.1272.002.D702.Qilalugene-P2_detailed.log,1732582,NS.1272.002
CCACAA,S_20_00812,8219182,20771,2598794,5599617,NS.1272.002.D702.Qilalugene-P2_detailed.log,2619565,NS.1272.002
CATCGT,S_20_00791,9752752,12025,3064819,6675908,NS.1272.002.D702.Qilalugene-P2_detailed.log,3076844,NS.1272.002
TGGCTA,S_20_00748,6593272,6183,2288628,4298461,NS.1272.002.D702.Qilalugene-P2_detailed.log,2294811,NS.1272.002
GTCGATT,S_20_00794,16222430,4968,4801385,11416077,NS.1272.002.D702.Qilalugene-P2_detailed.log,4806353,NS.1272.002
CGGTAGA,S_20_00611,6106032,1420,1987311,4117301,NS.1272.002.D702.Qilalugene-P2_detailed.log,1988731,NS.1272.002
TAGCATGG,S_20_01418,6275112,5157,1992566,4277389,NS.1272.002.D702.Qilalugene-P2_detailed.log,1997723,NS.1272.002
ACAGGGA,S_20_00763,384832,1621,135595,247616,NS.1272.002.D702.Qilalugene-P2_detailed.log,137216,NS.1272.002
TATCGGGA,S_20_00708,3140762,2650,839920,2298192,NS.1272.002.D702.Qilalugene-P2_detailed.log,842570,NS.1272.002
GTAA,S_20_00759,7857716,196890,2695734,4965092,NS.1272.002.D702.Qilalugene-P2_detailed.log,2892624,NS.1272.002
ACAAA,S_20_00813,12640296,202177,4115113,8323006,NS.1272.002.D702.Qilalugene-P2_detailed.log,4317290,NS.1272.002
AGGAT,S_20_00617,10070772,28631,3107098,6935043,NS.1272.002.D702.Qilalugene-P2_detailed.log,3135729,NS.1272.002
TACAT,S_20_00795,8598730,83194,2651391,5864145,NS.1272.002.D702.Qilalugene-P2_detailed.log,2734585,NS.1272.002
CTTCCA,S_20_00633,10837074,8796,3199240,7629038,NS.1272.002.D702.Qilalugene-P2_detailed.log,3208036,NS.1272.002
CGCGGT,S_20_00764,11188226,5723,4163745,7018758,NS.1272.002.D702.Qilalugene-P2_detailed.log,4169468,NS.1272.002
TATTTTT,S_20_00745,6814420,7655,2229662,4577103,NS.1272.002.D702.Qilalugene-P2_detailed.log,2237317,NS.1272.002
AACGCCT,S_20_00710,14977806,7030,4692669,10278107,NS.1272.002.D702.Qilalugene-P2_detailed.log,4699699,NS.1272.002
CTACGGA,S_20_00782,1703528,1678,601201,1100649,NS.1272.002.D702.Qilalugene-P2_detailed.log,602879,NS.1272.002
TAGGCCAT,S_20_03520,4904798,1312,1571970,3331516,NS.1272.002.D702.Qilalugene-P2_detailed.log,1573282,NS.1272.002
ACGTGGTA,S_20_01154,10274636,5055,3200413,7069168,NS.1272.002.D702.Qilalugene-P2_detailed.log,3205468,NS.1272.002
TTCCTGGA,S_20_00798,8773874,5191,2639832,6128851,NS.1272.002.D702.Qilalugene-P2_detailed.log,2645023,NS.1272.002
CTCG,S_20_01945,1677988,91542,277300,1309146,NS.1272.002.D703.Qilalugene-P3_detailed.log,368842,NS.1272.002
AGCG,S_20_01904,5829838,123026,1369879,4336933,NS.1272.002.D703.Qilalugene-P3_detailed.log,1492905,NS.1272.002
TTCTG,S_20_02582,4553276,9323,658935,3885018,NS.1272.002.D703.Qilalugene-P3_detailed.log,668258,NS.1272.002
ATTGA,S_20_00856_rep,2113516,45483,447941,1620092,NS.1272.002.D703.Qilalugene-P3_detailed.log,493424,NS.1272.002
TCGTT,S_20_00656,4903620,9691,789722,4104207,NS.1272.002.D703.Qilalugene-P3_detailed.log,799413,NS.1272.002
GAGATA,S_20_02963,7751772,5365,1213525,6532882,NS.1272.002.D703.Qilalugene-P3_detailed.log,1218890,NS.1272.002
CTATTA,S_20_01099,3638314,6272,847192,2784850,NS.1272.002.D703.Qilalugene-P3_detailed.log,853464,NS.1272.002
CTTGCTT,S_20_02103,20142752,4469,3048789,17089494,NS.1272.002.D703.Qilalugene-P3_detailed.log,3053258,NS.1272.002
AATATGG,S_20_03635,8330614,17035,1282360,7031219,NS.1272.002.D703.Qilalugene-P3_detailed.log,1299395,NS.1272.002
GCGGAAT,S_20_02356,4850004,2238,684627,4163139,NS.1272.002.D703.Qilalugene-P3_detailed.log,686865,NS.1272.002
TGCAAGGA,S_20_02388,4674336,636,673332,4000368,NS.1272.002.D703.Qilalugene-P3_detailed.log,673968,NS.1272.002
CCATGGGT,S_20_02352,8175032,9609,1369249,6796174,NS.1272.002.D703.Qilalugene-P3_detailed.log,1378858,NS.1272.002
TGCA,S_20_03419,3366040,65057,489899,2811084,NS.1272.002.D703.Qilalugene-P3_detailed.log,554956,NS.1272.002
GATG,S_20_01893,18906628,104839,2152887,16648902,NS.1272.002.D703.Qilalugene-P3_detailed.log,2257726,NS.1272.002
AGCCG,S_20_01019,6309570,12223,787393,5509954,NS.1272.002.D703.Qilalugene-P3_detailed.log,799616,NS.1272.002
CATCT,S_20_03586,14255018,36606,2136366,12082046,NS.1272.002.D703.Qilalugene-P3_detailed.log,2172972,NS.1272.002
GGTTGT,S_20_00836,5607978,2988,755124,4849866,NS.1272.002.D703.Qilalugene-P3_detailed.log,758112,NS.1272.002
ATGCCT,S_20_00916,8118998,5831,1273848,6839319,NS.1272.002.D703.Qilalugene-P3_detailed.log,1279679,NS.1272.002
GCCAGT,S_20_00925,3766678,6704,662896,3097078,NS.1272.002.D703.Qilalugene-P3_detailed.log,669600,NS.1272.002
ATGAAAG,S_20_00905,10347110,11744,1673636,8661730,NS.1272.002.D703.Qilalugene-P3_detailed.log,1685380,NS.1272.002
ACGTGTT,S_20_00942,4671462,4968,748511,3917983,NS.1272.002.D703.Qilalugene-P3_detailed.log,753479,NS.1272.002
TAGCGGA,S_20_03000,5301776,6903,805599,4489274,NS.1272.002.D703.Qilalugene-P3_detailed.log,812502,NS.1272.002
TGGTACGT,S_20_01018,1682350,347,291852,1390151,NS.1272.002.D703.Qilalugene-P3_detailed.log,292199,NS.1272.002
CGCGGAGA,S_20_03656,7441760,1132,1422562,6018066,NS.1272.002.D703.Qilalugene-P3_detailed.log,1423694,NS.1272.002
ACTA,S_20_02178,3619802,166907,520575,2932320,NS.1272.002.D703.Qilalugene-P3_detailed.log,687482,NS.1272.002
TCAG,S_20_03583,7010336,56396,1101454,5852486,NS.1272.002.D703.Qilalugene-P3_detailed.log,1157850,NS.1272.002
GTATT,S_20_02392,6327756,11154,964392,5352210,NS.1272.002.D703.Qilalugene-P3_detailed.log,975546,NS.1272.002
CCTAG,S_20_01883,17392388,11247,2342129,15039012,NS.1272.002.D703.Qilalugene-P3_detailed.log,2353376,NS.1272.002
CCACGT,S_20_01022,2528330,45285,542391,1940654,NS.1272.002.D703.Qilalugene-P3_detailed.log,587676,NS.1272.002
AGTGGA,S_20_00978,3299204,15965,768203,2515036,NS.1272.002.D703.Qilalugene-P3_detailed.log,784168,NS.1272.002
GGAAGA,S_20_01126,2038714,6479,348444,1683791,NS.1272.002.D703.Qilalugene-P3_detailed.log,354923,NS.1272.002
AAAAGTT,S_20_01077,2598456,34069,537052,2027335,NS.1272.002.D703.Qilalugene-P3_detailed.log,571121,NS.1272.002
ATTAATT,S_20_03029,6935172,5439,1341172,5588561,NS.1272.002.D703.Qilalugene-P3_detailed.log,1346611,NS.1272.002
TCGAAGA,S_20_01940,5391310,4005,941195,4446110,NS.1272.002.D703.Qilalugene-P3_detailed.log,945200,NS.1272.002
TCTCAGTG,S_20_02728,4318394,2806,810454,3505134,NS.1272.002.D703.Qilalugene-P3_detailed.log,813260,NS.1272.002
CGTGTGGT,S_20_00856,3412864,3943,735855,2673066,NS.1272.002.D703.Qilalugene-P3_detailed.log,739798,NS.1272.002
CAGA,S_20_01013,1186898,164820,228754,793324,NS.1272.002.D703.Qilalugene-P3_detailed.log,393574,NS.1272.002
TGCGA,S_20_03085,11524944,3505,1639507,9881932,NS.1272.002.D703.Qilalugene-P3_detailed.log,1643012,NS.1272.002
CTGTA,S_20_00996,1795838,9631,466544,1319663,NS.1272.002.D703.Qilalugene-P3_detailed.log,476175,NS.1272.002
GAGGA,S_20_01944,13968754,53512,2124609,11790633,NS.1272.002.D703.Qilalugene-P3_detailed.log,2178121,NS.1272.002
TTCAGA,S_20_01147,1686332,1211,298255,1386866,NS.1272.002.D703.Qilalugene-P3_detailed.log,299466,NS.1272.002
ACCTAA,S_20_03588,10280284,6964,1570650,8702670,NS.1272.002.D703.Qilalugene-P3_detailed.log,1577614,NS.1272.002
GTACTT,S_20_03090,4702640,4807,891040,3806793,NS.1272.002.D703.Qilalugene-P3_detailed.log,895847,NS.1272.002
GAATTCA,S_20_03038,2320982,3010,587564,1730408,NS.1272.002.D703.Qilalugene-P3_detailed.log,590574,NS.1272.002
ATTGGAT,S_20_01005,6051928,3630,885332,5162966,NS.1272.002.D703.Qilalugene-P3_detailed.log,888962,NS.1272.002
TCTGTGA,S_20_02108,6271130,597,918436,5352097,NS.1272.002.D703.Qilalugene-P3_detailed.log,919033,NS.1272.002
CGCGATAT,S_20_02257,1979854,667,245177,1734010,NS.1272.002.D703.Qilalugene-P3_detailed.log,245844,NS.1272.002
GCTGTGGA,S_20_02767,5546482,576,1041656,4504250,NS.1272.002.D703.Qilalugene-P3_detailed.log,1042232,NS.1272.002
AACT,S_20_02726,3776148,175193,605884,2995071,NS.1272.002.D703.Qilalugene-P3_detailed.log,781077,NS.1272.002
CGCTT,S_20_00995,2426266,9972,631996,1784298,NS.1272.002.D703.Qilalugene-P3_detailed.log,641968,NS.1272.002
ACCGT,S_20_01084,2345168,28425,424953,1891790,NS.1272.002.D703.Qilalugene-P3_detailed.log,453378,NS.1272.002
GGAAG,S_20_00828,12806660,37029,2041633,10727998,NS.1272.002.D703.Qilalugene-P3_detailed.log,2078662,NS.1272.002
TAGGAA,S_20_00918,2264370,7624,324823,1931923,NS.1272.002.D703.Qilalugene-P3_detailed.log,332447,NS.1272.002
ATATGT,S_20_02354,7587778,23260,1135627,6428891,NS.1272.002.D703.Qilalugene-P3_detailed.log,1158887,NS.1272.002
GTTGAA,S_20_00861,2438608,581,335901,2102126,NS.1272.002.D703.Qilalugene-P3_detailed.log,336482,NS.1272.002
GAACTTG,S_20_03087,6115808,17607,809560,5288641,NS.1272.002.D703.Qilalugene-P3_detailed.log,827167,NS.1272.002
CATAAGT,S_20_01894,4250370,2584,702287,3545499,NS.1272.002.D703.Qilalugene-P3_detailed.log,704871,NS.1272.002
TGCTGGA,S_20_03624,4356054,347,710055,3645652,NS.1272.002.D703.Qilalugene-P3_detailed.log,710402,NS.1272.002
CGCCTTAT,S_20_00985,1259230,588,336731,921911,NS.1272.002.D703.Qilalugene-P3_detailed.log,337319,NS.1272.002
GGATTGGT,S_20_01004,2629948,862,743000,1886086,NS.1272.002.D703.Qilalugene-P3_detailed.log,743862,NS.1272.002
GCGT,S_20_00998,752412,60342,237155,454915,NS.1272.002.D703.Qilalugene-P3_detailed.log,297497,NS.1272.002
TCACG,S_20_02385,7426532,19041,1097989,6309502,NS.1272.002.D703.Qilalugene-P3_detailed.log,1117030,NS.1272.002
GCTTA,S_20_03056,1768538,5647,432148,1330743,NS.1272.002.D703.Qilalugene-P3_detailed.log,437795,NS.1272.002
GTCAA,S_20_02910,10145760,17358,1710010,8418392,NS.1272.002.D703.Qilalugene-P3_detailed.log,1727368,NS.1272.002
GCTCTA,S_20_01011,833328,1428,312631,519269,NS.1272.002.D703.Qilalugene-P3_detailed.log,314059,NS.1272.002
ATCGTA,S_20_00964,3083888,5419,748462,2330007,NS.1272.002.D703.Qilalugene-P3_detailed.log,753881,NS.1272.002
TAACGA,S_20_01023,2148184,23222,380835,1744127,NS.1272.002.D703.Qilalugene-P3_detailed.log,404057,NS.1272.002
GGACCTA,S_20_03625,1897352,1100,265173,1631079,NS.1272.002.D703.Qilalugene-P3_detailed.log,266273,NS.1272.002
CGCTGAT,S_20_01050,6574960,2522,1074367,5498071,NS.1272.002.D703.Qilalugene-P3_detailed.log,1076889,NS.1272.002
ACGACTAG,S_20_02382,5211738,3881,893880,4313977,NS.1272.002.D703.Qilalugene-P3_detailed.log,897761,NS.1272.002
AACCGAGA,S_20_00920,3702740,3926,699107,2999707,NS.1272.002.D703.Qilalugene-P3_detailed.log,703033,NS.1272.002
GTGAGGGT,S_20_01092,3221454,1619,618343,2601492,NS.1272.002.D703.Qilalugene-P3_detailed.log,619962,NS.1272.002
CGAT,S_20_00850,1511826,133235,308582,1070009,NS.1272.002.D703.Qilalugene-P3_detailed.log,441817,NS.1272.002
CTAGG,S_20_03086,6094080,48046,944241,5101793,NS.1272.002.D703.Qilalugene-P3_detailed.log,992287,NS.1272.002
GGTGT,S_20_00646,3280840,24219,708991,2547630,NS.1272.002.D703.Qilalugene-P3_detailed.log,733210,NS.1272.002
TAATA,S_20_03344,10596476,51155,1884630,8660691,NS.1272.002.D703.Qilalugene-P3_detailed.log,1935785,NS.1272.002
CCACAA,S_20_03630,4849122,11610,678272,4159240,NS.1272.002.D703.Qilalugene-P3_detailed.log,689882,NS.1272.002
CATCGT,S_20_01097,8153748,20841,1198426,6934481,NS.1272.002.D703.Qilalugene-P3_detailed.log,1219267,NS.1272.002
TGGCTA,S_20_00983,3179296,3858,618613,2556825,NS.1272.002.D703.Qilalugene-P3_detailed.log,622471,NS.1272.002
GTCGATT,S_20_03210,4772854,2234,784064,3986556,NS.1272.002.D703.Qilalugene-P3_detailed.log,786298,NS.1272.002
CGGTAGA,S_20_03099,2775888,431,511078,2264379,NS.1272.002.D703.Qilalugene-P3_detailed.log,511509,NS.1272.002
TAGCATGG,S_20_01793,5900480,5780,1246087,4648613,NS.1272.002.D703.Qilalugene-P3_detailed.log,1251867,NS.1272.002
ACAGGGA,S_20_01025,2586834,3371,470576,2112887,NS.1272.002.D703.Qilalugene-P3_detailed.log,473947,NS.1272.002
TATCGGGA,S_20_00862,5961740,5434,1159285,4797021,NS.1272.002.D703.Qilalugene-P3_detailed.log,1164719,NS.1272.002
GTAA,S_20_03486,3668466,109706,559053,2999707,NS.1272.002.D703.Qilalugene-P3_detailed.log,668759,NS.1272.002
ACAAA,S_20_03665,3616556,146700,695598,2774258,NS.1272.002.D703.Qilalugene-P3_detailed.log,842298,NS.1272.002
AGGAT,S_20_03083,4543220,21750,766249,3755221,NS.1272.002.D703.Qilalugene-P3_detailed.log,787999,NS.1272.002
TACAT,S_20_00832,5912202,39790,1042588,4829824,NS.1272.002.D703.Qilalugene-P3_detailed.log,1082378,NS.1272.002
CTTCCA,S_20_01052,2814204,4693,437673,2371838,NS.1272.002.D703.Qilalugene-P3_detailed.log,442366,NS.1272.002
CGCGGT,S_20_02608,6376054,3380,950921,5421753,NS.1272.002.D703.Qilalugene-P3_detailed.log,954301,NS.1272.002
TATTTTT,S_20_01013_rep,3473230,3873,671785,2797572,NS.1272.002.D703.Qilalugene-P3_detailed.log,675658,NS.1272.002
AACGCCT,S_20_03212,3418876,1735,491744,2925397,NS.1272.002.D703.Qilalugene-P3_detailed.log,493479,NS.1272.002
CTACGGA,S_20_01075,6211276,4936,1095131,5111209,NS.1272.002.D703.Qilalugene-P3_detailed.log,1100067,NS.1272.002
TAGGCCAT,S_20_00651,4087742,1241,742414,3344087,NS.1272.002.D703.Qilalugene-P3_detailed.log,743655,NS.1272.002
ACGTGGTA,S_20_01938,2817822,2670,374702,2440450,NS.1272.002.D703.Qilalugene-P3_detailed.log,377372,NS.1272.002
TTCCTGGA,S_20_00988,2545606,1793,751394,1792419,NS.1272.002.D703.Qilalugene-P3_detailed.log,753187,NS.1272.002
CTCG,S_20_01873,3639432,49049,156265,3434118,NS.1272.002.D704.Qilalugene-P4_detailed.log,205314,NS.1272.002
AGCG,S_20_03605,2164704,107232,130281,1927191,NS.1272.002.D704.Qilalugene-P4_detailed.log,237513,NS.1272.002
TTCTG,S_20_00640,3279734,8119,371728,2899887,NS.1272.002.D704.Qilalugene-P4_detailed.log,379847,NS.1272.002
ATTGA,S_20_01896,11622466,44181,601681,10976604,NS.1272.002.D704.Qilalugene-P4_detailed.log,645862,NS.1272.002
TCGTT,S_20_03527,16377536,16234,865102,15496200,NS.1272.002.D704.Qilalugene-P4_detailed.log,881336,NS.1272.002
GAGATA,S_20_01027,1226698,4478,186149,1036071,NS.1272.002.D704.Qilalugene-P4_detailed.log,190627,NS.1272.002
CTATTA,S_20_01629,11050746,8894,825437,10216415,NS.1272.002.D704.Qilalugene-P4_detailed.log,834331,NS.1272.002
CTTGCTT,S_20_01076,4540190,1249,271474,4267467,NS.1272.002.D704.Qilalugene-P4_detailed.log,272723,NS.1272.002
AATATGG,S_20_01046,1710162,8228,103792,1598142,NS.1272.002.D704.Qilalugene-P4_detailed.log,112020,NS.1272.002
GCGGAAT,S_20_01070,516786,1149,82242,433395,NS.1272.002.D704.Qilalugene-P4_detailed.log,83391,NS.1272.002
TGCAAGGA,S_20_01906,8602100,1261,437465,8163374,NS.1272.002.D704.Qilalugene-P4_detailed.log,438726,NS.1272.002
CCATGGGT,S_20_00915,1688920,2015,160696,1526209,NS.1272.002.D704.Qilalugene-P4_detailed.log,162711,NS.1272.002
TGCA,S_20_01947,4013868,106948,310052,3596868,NS.1272.002.D704.Qilalugene-P4_detailed.log,417000,NS.1272.002
GATG,S_20_02611,7169102,97214,423482,6648406,NS.1272.002.D704.Qilalugene-P4_detailed.log,520696,NS.1272.002
AGCCG,S_20_02182,8194772,15004,417606,7762162,NS.1272.002.D704.Qilalugene-P4_detailed.log,432610,NS.1272.002
CATCT,S_20_02258,8025286,29000,463189,7533097,NS.1272.002.D704.Qilalugene-P4_detailed.log,492189,NS.1272.002
GGTTGT,S_20_01791,13051964,6593,523382,12521989,NS.1272.002.D704.Qilalugene-P4_detailed.log,529975,NS.1272.002
ATGCCT,S_20_00952,9794988,6089,547573,9241326,NS.1272.002.D704.Qilalugene-P4_detailed.log,553662,NS.1272.002
GCCAGT,S_20_00999,1752742,3283,286159,1463300,NS.1272.002.D704.Qilalugene-P4_detailed.log,289442,NS.1272.002
ATGAAAG,S_20_03608,28887428,32397,1602426,27252605,NS.1272.002.D704.Qilalugene-P4_detailed.log,1634823,NS.1272.002
ACGTGTT,S_20_02374,4215314,4163,228945,3982206,NS.1272.002.D704.Qilalugene-P4_detailed.log,233108,NS.1272.002
TAGCGGA,S_20_02908,3465384,4891,188324,3272169,NS.1272.002.D704.Qilalugene-P4_detailed.log,193215,NS.1272.002
TGGTACGT,S_20_00987,2135326,711,205570,1929045,NS.1272.002.D704.Qilalugene-P4_detailed.log,206281,NS.1272.002
CGCGGAGA,S_20_02635,2947748,617,177031,2770100,NS.1272.002.D704.Qilalugene-P4_detailed.log,177648,NS.1272.002
ACTA,S_20_00829,4047318,154146,238326,3654846,NS.1272.002.D704.Qilalugene-P4_detailed.log,392472,NS.1272.002
TCAG,S_20_03187,1476938,50086,193189,1233663,NS.1272.002.D704.Qilalugene-P4_detailed.log,243275,NS.1272.002
GTATT,S_20_00676,2262162,20505,270832,1970825,NS.1272.002.D704.Qilalugene-P4_detailed.log,291337,NS.1272.002
CCTAG,S_20_00912,9446370,7347,400050,9038973,NS.1272.002.D704.Qilalugene-P4_detailed.log,407397,NS.1272.002
CCACGT,S_20_03343,7021042,25788,380147,6615107,NS.1272.002.D704.Qilalugene-P4_detailed.log,405935,NS.1272.002
AGTGGA,S_20_01942,8133684,12223,373541,7747920,NS.1272.002.D704.Qilalugene-P4_detailed.log,385764,NS.1272.002
GGAAGA,S_20_02353,10361128,2697,497366,9861065,NS.1272.002.D704.Qilalugene-P4_detailed.log,500063,NS.1272.002
AAAAGTT,S_20_03088,11076688,35086,684065,10357537,NS.1272.002.D704.Qilalugene-P4_detailed.log,719151,NS.1272.002
ATTAATT,S_20_01797,4666238,5855,328435,4331948,NS.1272.002.D704.Qilalugene-P4_detailed.log,334290,NS.1272.002
TCGAAGA,S_20_03340,2679514,2742,138760,2538012,NS.1272.002.D704.Qilalugene-P4_detailed.log,141502,NS.1272.002
TCTCAGTG,S_20_03577,3141620,2292,200921,2938407,NS.1272.002.D704.Qilalugene-P4_detailed.log,203213,NS.1272.002
CGTGTGGT,S_20_01007,823516,1214,98911,723391,NS.1272.002.D704.Qilalugene-P4_detailed.log,100125,NS.1272.002
CAGA,S_20_01113,2579682,123962,161227,2294493,NS.1272.002.D704.Qilalugene-P4_detailed.log,285189,NS.1272.002
TGCGA,S_20_00917,8040180,3686,351372,7685122,NS.1272.002.D704.Qilalugene-P4_detailed.log,355058,NS.1272.002
CTGTA,S_20_00992,1690204,7480,182612,1500112,NS.1272.002.D704.Qilalugene-P4_detailed.log,190092,NS.1272.002
GAGGA,S_20_01706,6143822,32062,294664,5817096,NS.1272.002.D704.Qilalugene-P4_detailed.log,326726,NS.1272.002
TTCAGA,S_20_01986,8359756,2961,413704,7943091,NS.1272.002.D704.Qilalugene-P4_detailed.log,416665,NS.1272.002
ACCTAA,S_20_03582,8059326,6080,425596,7627650,NS.1272.002.D704.Qilalugene-P4_detailed.log,431676,NS.1272.002
GTACTT,S_20_00833,9735124,14624,621380,9099120,NS.1272.002.D704.Qilalugene-P4_detailed.log,636004,NS.1272.002
GAATTCA,S_20_02350,11880704,8136,646514,11226054,NS.1272.002.D704.Qilalugene-P4_detailed.log,654650,NS.1272.002
ATTGGAT,S_20_01040,3880554,6013,206647,3667894,NS.1272.002.D704.Qilalugene-P4_detailed.log,212660,NS.1272.002
TCTGTGA,S_20_01078,2825928,339,150481,2675108,NS.1272.002.D704.Qilalugene-P4_detailed.log,150820,NS.1272.002
CGCGATAT,S_20_01900,2325990,735,163458,2161797,NS.1272.002.D704.Qilalugene-P4_detailed.log,164193,NS.1272.002
GCTGTGGA,S_20_00943,2593662,353,145183,2448126,NS.1272.002.D704.Qilalugene-P4_detailed.log,145536,NS.1272.002
AACT,S_20_00866,4577734,176722,269291,4131721,NS.1272.002.D704.Qilalugene-P4_detailed.log,446013,NS.1272.002
CGCTT,S_20_00655,344650,11021,70579,263050,NS.1272.002.D704.Qilalugene-P4_detailed.log,81600,NS.1272.002
ACCGT,S_20_02115,2298314,24856,158574,2114884,NS.1272.002.D704.Qilalugene-P4_detailed.log,183430,NS.1272.002
GGAAG,S_20_00835,1564502,66094,209930,1288478,NS.1272.002.D704.Qilalugene-P4_detailed.log,276024,NS.1272.002
TAGGAA,S_20_02179,6946460,6815,336756,6602889,NS.1272.002.D704.Qilalugene-P4_detailed.log,343571,NS.1272.002
ATATGT,S_20_01630,5208798,12993,365874,4829931,NS.1272.002.D704.Qilalugene-P4_detailed.log,378867,NS.1272.002
GTTGAA,S_20_03035,7741024,1708,524505,7214811,NS.1272.002.D704.Qilalugene-P4_detailed.log,526213,NS.1272.002
GAACTTG,S_20_00899,9480914,22757,830270,8627887,NS.1272.002.D704.Qilalugene-P4_detailed.log,853027,NS.1272.002
CATAAGT,S_20_03092,2665406,2119,147642,2515645,NS.1272.002.D704.Qilalugene-P4_detailed.log,149761,NS.1272.002
TGCTGGA,S_20_03525,3079282,359,150384,2928539,NS.1272.002.D704.Qilalugene-P4_detailed.log,150743,NS.1272.002
CGCCTTAT,S_20_02912,2507730,1242,159981,2346507,NS.1272.002.D704.Qilalugene-P4_detailed.log,161223,NS.1272.002
GGATTGGT,S_20_03599,4098210,2854,203834,3891522,NS.1272.002.D704.Qilalugene-P4_detailed.log,206688,NS.1272.002
GCGT,S_20_02102,3739678,97753,197687,3444238,NS.1272.002.D704.Qilalugene-P4_detailed.log,295440,NS.1272.002
TCACG,S_20_01098,2706242,15384,186174,2504684,NS.1272.002.D704.Qilalugene-P4_detailed.log,201558,NS.1272.002
GCTTA,S_20_03572,4646600,9289,254811,4382500,NS.1272.002.D704.Qilalugene-P4_detailed.log,264100,NS.1272.002
GTCAA,S_20_02104,6162506,21418,314806,5826282,NS.1272.002.D704.Qilalugene-P4_detailed.log,336224,NS.1272.002
GCTCTA,S_20_03218,3526184,2735,243914,3279535,NS.1272.002.D704.Qilalugene-P4_detailed.log,246649,NS.1272.002
ATCGTA,S_20_03095,4674650,5654,204683,4464313,NS.1272.002.D704.Qilalugene-P4_detailed.log,210337,NS.1272.002
TAACGA,S_20_01002,3304372,19029,379139,2906204,NS.1272.002.D704.Qilalugene-P4_detailed.log,398168,NS.1272.002
GGACCTA,S_20_02177,5185154,3599,360218,4821337,NS.1272.002.D704.Qilalugene-P4_detailed.log,363817,NS.1272.002
CGCTGAT,S_20_02911,2380632,1675,175642,2203315,NS.1272.002.D704.Qilalugene-P4_detailed.log,177317,NS.1272.002
ACGACTAG,S_20_00896,789972,888,105803,683281,NS.1272.002.D704.Qilalugene-P4_detailed.log,106691,NS.1272.002
AACCGAGA,S_20_01099_rep,3063274,3635,220526,2839113,NS.1272.002.D704.Qilalugene-P4_detailed.log,224161,NS.1272.002
GTGAGGGT,S_20_01210,2771660,2902,140667,2628091,NS.1272.002.D704.Qilalugene-P4_detailed.log,143569,NS.1272.002
CGAT,S_20_01107,987172,141278,100877,745017,NS.1272.002.D704.Qilalugene-P4_detailed.log,242155,NS.1272.002
CTAGG,S_20_03477,414728,23028,116879,274821,NS.1272.002.D704.Qilalugene-P4_detailed.log,139907,NS.1272.002
GGTGT,S_20_01006,2272226,15545,229821,2026860,NS.1272.002.D704.Qilalugene-P4_detailed.log,245366,NS.1272.002
TAATA,S_20_00955,3470960,53275,313664,3104021,NS.1272.002.D704.Qilalugene-P4_detailed.log,366939,NS.1272.002
CCACAA,S_20_03118,5486882,12322,252524,5222036,NS.1272.002.D704.Qilalugene-P4_detailed.log,264846,NS.1272.002
CATCGT,S_20_00967,1935440,11467,215806,1708167,NS.1272.002.D704.Qilalugene-P4_detailed.log,227273,NS.1272.002
TGGCTA,S_20_02100,7744058,5982,564876,7173200,NS.1272.002.D704.Qilalugene-P4_detailed.log,570858,NS.1272.002
GTCGATT,S_20_00997,1378112,607,359652,1017853,NS.1272.002.D704.Qilalugene-P4_detailed.log,360259,NS.1272.002
CGGTAGA,S_20_03595,3188624,530,149128,3038966,NS.1272.002.D704.Qilalugene-P4_detailed.log,149658,NS.1272.002
TAGCATGG,S_20_03096,3111278,3848,173061,2934369,NS.1272.002.D704.Qilalugene-P4_detailed.log,176909,NS.1272.002
ACAGGGA,S_20_01088,3221850,4497,162068,3055285,NS.1272.002.D704.Qilalugene-P4_detailed.log,166565,NS.1272.002
TATCGGGA,S_20_01707,3001120,3063,214750,2783307,NS.1272.002.D704.Qilalugene-P4_detailed.log,217813,NS.1272.002
GTAA,S_20_00682,1480550,146153,148002,1186395,NS.1272.002.D704.Qilalugene-P4_detailed.log,294155,NS.1272.002
ACAAA,S_20_00976,2340440,157150,168513,2014777,NS.1272.002.D704.Qilalugene-P4_detailed.log,325663,NS.1272.002
AGGAT,S_20_00638,1606388,33928,161880,1410580,NS.1272.002.D704.Qilalugene-P4_detailed.log,195808,NS.1272.002
TACAT,S_20_03633,6987228,55548,366520,6565160,NS.1272.002.D704.Qilalugene-P4_detailed.log,422068,NS.1272.002
CTTCCA,S_20_00649,5050968,4789,284297,4761882,NS.1272.002.D704.Qilalugene-P4_detailed.log,289086,NS.1272.002
CGCGGT,S_20_00957,2241404,1524,213781,2026099,NS.1272.002.D704.Qilalugene-P4_detailed.log,215305,NS.1272.002
TATTTTT,S_20_02255,6786834,8271,442189,6336374,NS.1272.002.D704.Qilalugene-P4_detailed.log,450460,NS.1272.002
AACGCCT,S_20_01102,3930730,2115,489185,3439430,NS.1272.002.D704.Qilalugene-P4_detailed.log,491300,NS.1272.002
CTACGGA,S_20_01071,4037436,3648,263435,3770353,NS.1272.002.D704.Qilalugene-P4_detailed.log,267083,NS.1272.002
TAGGCCAT,S_20_00704,1246684,542,117423,1128719,NS.1272.002.D704.Qilalugene-P4_detailed.log,117965,NS.1272.002
ACGTGGTA,S_20_00648,938964,1802,117023,820139,NS.1272.002.D704.Qilalugene-P4_detailed.log,118825,NS.1272.002
TTCCTGGA,S_20_00993,1809908,1632,194713,1613563,NS.1272.002.D704.Qilalugene-P4_detailed.log,196345,NS.1272.002
CTCG,S_20_03183,4263650,60342,516239,3687069,NS.1272.002.D705.Qilalugene-P5_detailed.log,576581,NS.1272.002
AGCG,S_20_00884,4807044,155708,467158,4184178,NS.1272.002.D705.Qilalugene-P5_detailed.log,622866,NS.1272.002
TTCTG,S_20_00639,5537430,15186,673388,4848856,NS.1272.002.D705.Qilalugene-P5_detailed.log,688574,NS.1272.002
ATTGA,S_20_03634,7775154,38427,544044,7192683,NS.1272.002.D705.Qilalugene-P5_detailed.log,582471,NS.1272.002
TCGTT,S_20_01863,15844464,18631,1208223,14617610,NS.1272.002.D705.Qilalugene-P5_detailed.log,1226854,NS.1272.002
GAGATA,S_20_01100,837980,4552,180659,652769,NS.1272.002.D705.Qilalugene-P5_detailed.log,185211,NS.1272.002
CTATTA,S_20_00994,1360456,8273,228609,1123574,NS.1272.002.D705.Qilalugene-P5_detailed.log,236882,NS.1272.002
CTTGCTT,S_20_00820,2733398,1244,285047,2447107,NS.1272.002.D705.Qilalugene-P5_detailed.log,286291,NS.1272.002
AATATGG,S_20_02174,11155362,25359,743729,10386274,NS.1272.002.D705.Qilalugene-P5_detailed.log,769088,NS.1272.002
GCGGAAT,S_20_03001,6314950,5169,416660,5893121,NS.1272.002.D705.Qilalugene-P5_detailed.log,421829,NS.1272.002
TGCAAGGA,S_20_01878,18088410,2570,1036532,17049308,NS.1272.002.D705.Qilalugene-P5_detailed.log,1039102,NS.1272.002
CCATGGGT,S_20_02539,2873120,4296,306892,2561932,NS.1272.002.D705.Qilalugene-P5_detailed.log,311188,NS.1272.002
TGCA,S_20_03636,20025830,157931,1272290,18595609,NS.1272.002.D705.Qilalugene-P5_detailed.log,1430221,NS.1272.002
GATG,S_20_02540,4152968,92444,576853,3483671,NS.1272.002.D705.Qilalugene-P5_detailed.log,669297,NS.1272.002
AGCCG,S_20_00645,3830514,13729,485715,3331070,NS.1272.002.D705.Qilalugene-P5_detailed.log,499444,NS.1272.002
CATCT,S_20_02364,7092314,35716,488575,6568023,NS.1272.002.D705.Qilalugene-P5_detailed.log,524291,NS.1272.002
GGTTGT,S_20_02537,6293184,3371,806912,5482901,NS.1272.002.D705.Qilalugene-P5_detailed.log,810283,NS.1272.002
ATGCCT,S_20_01009,6798372,5911,783815,6008646,NS.1272.002.D705.Qilalugene-P5_detailed.log,789726,NS.1272.002
GCCAGT,S_20_01008,1614604,6205,173787,1434612,NS.1272.002.D705.Qilalugene-P5_detailed.log,179992,NS.1272.002
ATGAAAG,S_20_01636,2038712,5894,196663,1836155,NS.1272.002.D705.Qilalugene-P5_detailed.log,202557,NS.1272.002
ACGTGTT,S_20_00926,5974664,5922,481880,5486862,NS.1272.002.D705.Qilalugene-P5_detailed.log,487802,NS.1272.002
TAGCGGA,S_20_00945,3004218,4081,412681,2587456,NS.1272.002.D705.Qilalugene-P5_detailed.log,416762,NS.1272.002
TGGTACGT,S_20_00966,1540494,387,189000,1351107,NS.1272.002.D705.Qilalugene-P5_detailed.log,189387,NS.1272.002
CGCGGAGA,S_20_00831,2108184,458,275533,1832193,NS.1272.002.D705.Qilalugene-P5_detailed.log,275991,NS.1272.002
ACTA,S_20_02444,8410412,269713,738790,7401909,NS.1272.002.D705.Qilalugene-P5_detailed.log,1008503,NS.1272.002
TCAG,S_20_00705,1566512,65478,227397,1273637,NS.1272.002.D705.Qilalugene-P5_detailed.log,292875,NS.1272.002
GTATT,S_20_00913,7835400,10356,471985,7353059,NS.1272.002.D705.Qilalugene-P5_detailed.log,482341,NS.1272.002
CCTAG,S_20_02362,4940852,8401,366507,4565944,NS.1272.002.D705.Qilalugene-P5_detailed.log,374908,NS.1272.002
CCACGT,S_20_03341,10807086,27827,696716,10082543,NS.1272.002.D705.Qilalugene-P5_detailed.log,724543,NS.1272.002
AGTGGA,S_20_03342,12008552,12547,813508,11182497,NS.1272.002.D705.Qilalugene-P5_detailed.log,826055,NS.1272.002
GGAAGA,S_20_02384,1384900,3328,79443,1302129,NS.1272.002.D705.Qilalugene-P5_detailed.log,82771,NS.1272.002
AAAAGTT,S_20_00634,558850,30952,70877,457021,NS.1272.002.D705.Qilalugene-P5_detailed.log,101829,NS.1272.002
ATTAATT,S_20_03054,13961780,15913,910068,13035799,NS.1272.002.D705.Qilalugene-P5_detailed.log,925981,NS.1272.002
TCGAAGA,S_20_01124,8921940,9223,622579,8290138,NS.1272.002.D705.Qilalugene-P5_detailed.log,631802,NS.1272.002
TCTCAGTG,S_20_02355,12473660,9152,877724,11586784,NS.1272.002.D705.Qilalugene-P5_detailed.log,886876,NS.1272.002
CGTGTGGT,S_20_03600,5803066,8137,345244,5449685,NS.1272.002.D705.Qilalugene-P5_detailed.log,353381,NS.1272.002
CAGA,S_20_01773,2154208,163653,430842,1559713,NS.1272.002.D705.Qilalugene-P5_detailed.log,594495,NS.1272.002
TGCGA,S_20_02381,6846858,5798,494009,6347051,NS.1272.002.D705.Qilalugene-P5_detailed.log,499807,NS.1272.002
CTGTA,S_20_01920,7933274,15160,542841,7375273,NS.1272.002.D705.Qilalugene-P5_detailed.log,558001,NS.1272.002
GAGGA,S_20_01637,4178878,68068,340291,3770519,NS.1272.002.D705.Qilalugene-P5_detailed.log,408359,NS.1272.002
TTCAGA,S_20_00953,993912,1549,246491,745872,NS.1272.002.D705.Qilalugene-P5_detailed.log,248040,NS.1272.002
ACCTAA,S_20_03585,18991630,18696,1188691,17784243,NS.1272.002.D705.Qilalugene-P5_detailed.log,1207387,NS.1272.002
GTACTT,S_20_03182,3896362,6175,345473,3544714,NS.1272.002.D705.Qilalugene-P5_detailed.log,351648,NS.1272.002
GAATTCA,S_20_00981,1114356,2363,152912,959081,NS.1272.002.D705.Qilalugene-P5_detailed.log,155275,NS.1272.002
ATTGGAT,S_20_03036,3823550,7384,399382,3416784,NS.1272.002.D705.Qilalugene-P5_detailed.log,406766,NS.1272.002
TCTGTGA,S_20_02373,5973710,834,474015,5498861,NS.1272.002.D705.Qilalugene-P5_detailed.log,474849,NS.1272.002
CGCGATAT,S_20_03037,3221266,937,333447,2886882,NS.1272.002.D705.Qilalugene-P5_detailed.log,334384,NS.1272.002
GCTGTGGA,S_20_03089,812912,109,56593,756210,NS.1272.002.D705.Qilalugene-P5_detailed.log,56702,NS.1272.002
AACT,S_20_02634,11876990,284465,837867,10754658,NS.1272.002.D705.Qilalugene-P5_detailed.log,1122332,NS.1272.002
CGCTT,S_20_01095,634052,17218,146697,470137,NS.1272.002.D705.Qilalugene-P5_detailed.log,163915,NS.1272.002
ACCGT,S_20_00685,2199360,34310,311841,1853209,NS.1272.002.D705.Qilalugene-P5_detailed.log,346151,NS.1272.002
GGAAG,S_20_00726_rep,5453896,47936,348618,5057342,NS.1272.002.D705.Qilalugene-P5_detailed.log,396554,NS.1272.002
TAGGAA,S_20_01018_rep,15678050,13297,1047397,14617356,NS.1272.002.D705.Qilalugene-P5_detailed.log,1060694,NS.1272.002
ATATGT,S_20_00948,1969982,23329,404761,1541892,NS.1272.002.D705.Qilalugene-P5_detailed.log,428090,NS.1272.002
GTTGAA,S_20_01991,2713252,1079,199064,2513109,NS.1272.002.D705.Qilalugene-P5_detailed.log,200143,NS.1272.002
GAACTTG,S_20_00917_rep,2362888,16642,189617,2156629,NS.1272.002.D705.Qilalugene-P5_detailed.log,206259,NS.1272.002
CATAAGT,S_20_03186,3744212,4222,386965,3353025,NS.1272.002.D705.Qilalugene-P5_detailed.log,391187,NS.1272.002
TGCTGGA,S_20_03618,6397702,612,385601,6011489,NS.1272.002.D705.Qilalugene-P5_detailed.log,386213,NS.1272.002
CGCCTTAT,S_20_01069,1288774,757,210806,1077211,NS.1272.002.D705.Qilalugene-P5_detailed.log,211563,NS.1272.002
GGATTGGT,S_20_00637,1197586,631,217469,979486,NS.1272.002.D705.Qilalugene-P5_detailed.log,218100,NS.1272.002
GCGT,S_20_01062,3175962,103290,235577,2837095,NS.1272.002.D705.Qilalugene-P5_detailed.log,338867,NS.1272.002
TCACG,S_20_02262,3500790,36503,272206,3192081,NS.1272.002.D705.Qilalugene-P5_detailed.log,308709,NS.1272.002
GCTTA,S_20_03626,6873298,13173,446014,6414111,NS.1272.002.D705.Qilalugene-P5_detailed.log,459187,NS.1272.002
GTCAA,S_20_00678,1918278,26963,271312,1620003,NS.1272.002.D705.Qilalugene-P5_detailed.log,298275,NS.1272.002
GCTCTA,S_20_01017,2548522,3114,484497,2060911,NS.1272.002.D705.Qilalugene-P5_detailed.log,487611,NS.1272.002
ATCGTA,S_20_01010,2852658,8215,403705,2440738,NS.1272.002.D705.Qilalugene-P5_detailed.log,411920,NS.1272.002
TAACGA,S_20_03480,2233654,18434,232704,1982516,NS.1272.002.D705.Qilalugene-P5_detailed.log,251138,NS.1272.002
GGACCTA,S_20_01794,1647364,1412,118135,1527817,NS.1272.002.D705.Qilalugene-P5_detailed.log,119547,NS.1272.002
CGCTGAT,S_20_02239,7736812,4078,514213,7218521,NS.1272.002.D705.Qilalugene-P5_detailed.log,518291,NS.1272.002
ACGACTAG,S_20_01626,4571050,4597,340454,4225999,NS.1272.002.D705.Qilalugene-P5_detailed.log,345051,NS.1272.002
AACCGAGA,S_20_01090,1918810,2864,351887,1564059,NS.1272.002.D705.Qilalugene-P5_detailed.log,354751,NS.1272.002
GTGAGGGT,S_20_01086,3324022,2787,214921,3106314,NS.1272.002.D705.Qilalugene-P5_detailed.log,217708,NS.1272.002
CGAT,S_20_02966,4298808,156963,374906,3766939,NS.1272.002.D705.Qilalugene-P5_detailed.log,531869,NS.1272.002
CTAGG,S_20_01792,3807132,25003,208676,3573453,NS.1272.002.D705.Qilalugene-P5_detailed.log,233679,NS.1272.002
GGTGT,S_20_02591,7692754,19728,414941,7258085,NS.1272.002.D705.Qilalugene-P5_detailed.log,434669,NS.1272.002
TAATA,S_20_00642,2422156,69368,322267,2030521,NS.1272.002.D705.Qilalugene-P5_detailed.log,391635,NS.1272.002
CCACAA,S_20_00881,3975742,19102,447413,3509227,NS.1272.002.D705.Qilalugene-P5_detailed.log,466515,NS.1272.002
CATCGT,S_20_01059,2036320,11088,314672,1710560,NS.1272.002.D705.Qilalugene-P5_detailed.log,325760,NS.1272.002
TGGCTA,S_20_00959,3934858,5872,268110,3660876,NS.1272.002.D705.Qilalugene-P5_detailed.log,273982,NS.1272.002
GTCGATT,S_20_01089,555606,371,163413,391822,NS.1272.002.D705.Qilalugene-P5_detailed.log,163784,NS.1272.002
CGGTAGA,S_20_01709,2860148,667,244934,2614547,NS.1272.002.D705.Qilalugene-P5_detailed.log,245601,NS.1272.002
TAGCATGG,S_20_00636,2279382,3158,387199,1889025,NS.1272.002.D705.Qilalugene-P5_detailed.log,390357,NS.1272.002
ACAGGGA,S_20_03623,1947906,3107,142018,1802781,NS.1272.002.D705.Qilalugene-P5_detailed.log,145125,NS.1272.002
TATCGGGA,S_20_00852,2080406,2138,269056,1809212,NS.1272.002.D705.Qilalugene-P5_detailed.log,271194,NS.1272.002
GTAA,S_20_02964,3860128,131008,340391,3388729,NS.1272.002.D705.Qilalugene-P5_detailed.log,471399,NS.1272.002
ACAAA,S_20_00857,3190818,282869,226693,2681256,NS.1272.002.D705.Qilalugene-P5_detailed.log,509562,NS.1272.002
AGGAT,S_20_00918_rep,5601854,27885,371483,5202486,NS.1272.002.D705.Qilalugene-P5_detailed.log,399368,NS.1272.002
TACAT,S_20_03039,4767804,82045,403244,4282515,NS.1272.002.D705.Qilalugene-P5_detailed.log,485289,NS.1272.002
CTTCCA,S_20_01080,6494102,7213,379958,6106931,NS.1272.002.D705.Qilalugene-P5_detailed.log,387171,NS.1272.002
CGCGGT,S_20_03106,6699190,4377,357250,6337563,NS.1272.002.D705.Qilalugene-P5_detailed.log,361627,NS.1272.002
TATTTTT,S_20_00870,2996424,5858,237540,2753026,NS.1272.002.D705.Qilalugene-P5_detailed.log,243398,NS.1272.002
AACGCCT,S_20_03628,3698332,2759,216826,3478747,NS.1272.002.D705.Qilalugene-P5_detailed.log,219585,NS.1272.002
CTACGGA,S_20_01012,2634686,2654,378481,2253551,NS.1272.002.D705.Qilalugene-P5_detailed.log,381135,NS.1272.002
TAGGCCAT,S_20_00946,1164162,492,223070,940600,NS.1272.002.D705.Qilalugene-P5_detailed.log,223562,NS.1272.002
ACGTGGTA,S_20_00849,2181434,3129,190828,1987477,NS.1272.002.D705.Qilalugene-P5_detailed.log,193957,NS.1272.002
TTCCTGGA,S_20_02961,4325492,3690,252711,4069091,NS.1272.002.D705.Qilalugene-P5_detailed.log,256401,NS.1272.002
CTCG,S_20_00834,3172698,70422,272897,2829379,NS.1272.002.D706.Qilalugene-P6_detailed.log,343319,NS.1272.002
AGCG,S_20_01044,2633138,113228,291576,2228334,NS.1272.002.D706.Qilalugene-P6_detailed.log,404804,NS.1272.002
TTCTG,S_20_03616,12384908,15746,1229808,11139354,NS.1272.002.D706.Qilalugene-P6_detailed.log,1245554,NS.1272.002
ATTGA,S_20_01628,4429002,26516,579393,3823093,NS.1272.002.D706.Qilalugene-P6_detailed.log,605909,NS.1272.002
TCGTT,S_20_02285,7213736,11235,1072941,6129560,NS.1272.002.D706.Qilalugene-P6_detailed.log,1084176,NS.1272.002
GAGATA,S_20_00944,11703314,7568,1298723,10397023,NS.1272.002.D706.Qilalugene-P6_detailed.log,1306291,NS.1272.002
CTATTA,S_20_01803,3452288,9252,372512,3070524,NS.1272.002.D706.Qilalugene-P6_detailed.log,381764,NS.1272.002
CTTGCTT,S_20_01065,2901896,913,298476,2602507,NS.1272.002.D706.Qilalugene-P6_detailed.log,299389,NS.1272.002
AATATGG,S_20_00869,1613626,5398,341173,1267055,NS.1272.002.D706.Qilalugene-P6_detailed.log,346571,NS.1272.002
GCGGAAT,S_20_01058,1600826,1158,295226,1304442,NS.1272.002.D706.Qilalugene-P6_detailed.log,296384,NS.1272.002
TGCAAGGA,S_20_03655,4976476,725,556532,4419219,NS.1272.002.D706.Qilalugene-P6_detailed.log,557257,NS.1272.002
CCATGGGT,S_20_03100,4138862,4939,453279,3680644,NS.1272.002.D706.Qilalugene-P6_detailed.log,458218,NS.1272.002
TGCA,S_20_02249,6583286,73430,662740,5847116,NS.1272.002.D706.Qilalugene-P6_detailed.log,736170,NS.1272.002
GATG,S_20_02659,3844158,117559,491111,3235488,NS.1272.002.D706.Qilalugene-P6_detailed.log,608670,NS.1272.002
AGCCG,S_20_03034,11859262,17133,1499926,10342203,NS.1272.002.D706.Qilalugene-P6_detailed.log,1517059,NS.1272.002
CATCT,S_20_00643,3266964,49163,477587,2740214,NS.1272.002.D706.Qilalugene-P6_detailed.log,526750,NS.1272.002
GGTTGT,S_20_03033,10488394,7129,1108588,9372677,NS.1272.002.D706.Qilalugene-P6_detailed.log,1115717,NS.1272.002
ATGCCT,S_20_00816,11502366,6973,1601822,9893571,NS.1272.002.D706.Qilalugene-P6_detailed.log,1608795,NS.1272.002
GCCAGT,S_20_01094,2582734,5126,231100,2346508,NS.1272.002.D706.Qilalugene-P6_detailed.log,236226,NS.1272.002
ATGAAAG,S_20_02610,4208210,7569,385827,3814814,NS.1272.002.D706.Qilalugene-P6_detailed.log,393396,NS.1272.002
ACGTGTT,S_20_03345,7259342,6419,796770,6456153,NS.1272.002.D706.Qilalugene-P6_detailed.log,803189,NS.1272.002
TAGCGGA,S_20_02261,5997932,7791,542896,5447245,NS.1272.002.D706.Qilalugene-P6_detailed.log,550687,NS.1272.002
TGGTACGT,S_20_02383,3307994,1068,262507,3044419,NS.1272.002.D706.Qilalugene-P6_detailed.log,263575,NS.1272.002
CGCGGAGA,S_20_03631,4536284,685,405320,4130279,NS.1272.002.D706.Qilalugene-P6_detailed.log,406005,NS.1272.002
ACTA,S_20_00885,2231024,194892,339694,1696438,NS.1272.002.D706.Qilalugene-P6_detailed.log,534586,NS.1272.002
TCAG,S_20_00924,2674046,44850,353578,2275618,NS.1272.002.D706.Qilalugene-P6_detailed.log,398428,NS.1272.002
GTATT,S_20_03649,18577690,20695,2105668,16451327,NS.1272.002.D706.Qilalugene-P6_detailed.log,2126363,NS.1272.002
CCTAG,S_20_03591,4227470,7673,366349,3853448,NS.1272.002.D706.Qilalugene-P6_detailed.log,374022,NS.1272.002
CCACGT,S_20_00965,2478984,18667,407916,2052401,NS.1272.002.D706.Qilalugene-P6_detailed.log,426583,NS.1272.002
AGTGGA,S_20_00974,2543042,13516,691417,1838109,NS.1272.002.D706.Qilalugene-P6_detailed.log,704933,NS.1272.002
GGAAGA,S_20_00680,923086,1885,119683,801518,NS.1272.002.D706.Qilalugene-P6_detailed.log,121568,NS.1272.002
AAAAGTT,S_20_01053,2077108,31109,169940,1876059,NS.1272.002.D706.Qilalugene-P6_detailed.log,201049,NS.1272.002
ATTAATT,S_20_02180,11960726,11066,1203226,10746434,NS.1272.002.D706.Qilalugene-P6_detailed.log,1214292,NS.1272.002
TCGAAGA,S_20_02849,3060152,3096,236498,2820558,NS.1272.002.D706.Qilalugene-P6_detailed.log,239594,NS.1272.002
TCTCAGTG,S_20_01708,6506302,4795,580003,5921504,NS.1272.002.D706.Qilalugene-P6_detailed.log,584798,NS.1272.002
CGTGTGGT,S_20_01098_rep,1803056,2444,353905,1446707,NS.1272.002.D706.Qilalugene-P6_detailed.log,356349,NS.1272.002
CAGA,S_20_01764,2948458,168880,235564,2544014,NS.1272.002.D706.Qilalugene-P6_detailed.log,404444,NS.1272.002
TGCGA,S_20_02256,5792132,2574,491222,5298336,NS.1272.002.D706.Qilalugene-P6_detailed.log,493796,NS.1272.002
CTGTA,S_20_01631,8890728,14239,1027349,7849140,NS.1272.002.D706.Qilalugene-P6_detailed.log,1041588,NS.1272.002
GAGGA,S_20_01067,891254,25229,208244,657781,NS.1272.002.D706.Qilalugene-P6_detailed.log,233473,NS.1272.002
TTCAGA,S_20_02538,1642456,1593,456055,1184808,NS.1272.002.D706.Qilalugene-P6_detailed.log,457648,NS.1272.002
ACCTAA,S_20_00849_rep,14924446,11191,1322568,13590687,NS.1272.002.D706.Qilalugene-P6_detailed.log,1333759,NS.1272.002
GTACTT,S_20_01771,4087436,6007,327579,3753850,NS.1272.002.D706.Qilalugene-P6_detailed.log,333586,NS.1272.002
GAATTCA,S_20_00882,993304,1945,173297,818062,NS.1272.002.D706.Qilalugene-P6_detailed.log,175242,NS.1272.002
ATTGGAT,S_20_03573,4771692,3386,491027,4277279,NS.1272.002.D706.Qilalugene-P6_detailed.log,494413,NS.1272.002
TCTGTGA,S_20_02386,3423176,466,372363,3050347,NS.1272.002.D706.Qilalugene-P6_detailed.log,372829,NS.1272.002
CGCGATAT,S_20_00979,1072332,593,180328,891411,NS.1272.002.D706.Qilalugene-P6_detailed.log,180921,NS.1272.002
GCTGTGGA,S_20_00686,5456922,675,551514,4904733,NS.1272.002.D706.Qilalugene-P6_detailed.log,552189,NS.1272.002
AACT,S_20_03607,4185534,257740,456364,3471430,NS.1272.002.D706.Qilalugene-P6_detailed.log,714104,NS.1272.002
CGCTT,S_20_01795,177310,13255,46531,117524,NS.1272.002.D706.Qilalugene-P6_detailed.log,59786,NS.1272.002
ACCGT,S_20_02957,21536264,43776,2183229,19309259,NS.1272.002.D706.Qilalugene-P6_detailed.log,2227005,NS.1272.002
GGAAG,S_20_01632,3261382,32548,351013,2877821,NS.1272.002.D706.Qilalugene-P6_detailed.log,383561,NS.1272.002
TAGGAA,S_20_00855_rep,3408052,4513,411113,2992426,NS.1272.002.D706.Qilalugene-P6_detailed.log,415626,NS.1272.002
ATATGT,S_20_00649_rep,4078060,25502,788987,3263571,NS.1272.002.D706.Qilalugene-P6_detailed.log,814489,NS.1272.002
GTTGAA,S_20_01787,1776746,711,164852,1611183,NS.1272.002.D706.Qilalugene-P6_detailed.log,165563,NS.1272.002
GAACTTG,S_20_01064,838086,23656,193438,620992,NS.1272.002.D706.Qilalugene-P6_detailed.log,217094,NS.1272.002
CATAAGT,S_20_01068,2106772,1669,412053,1693050,NS.1272.002.D706.Qilalugene-P6_detailed.log,413722,NS.1272.002
TGCTGGA,S_20_00818,2472980,249,273107,2199624,NS.1272.002.D706.Qilalugene-P6_detailed.log,273356,NS.1272.002
CGCCTTAT,S_20_00860,2580172,1196,282116,2296860,NS.1272.002.D706.Qilalugene-P6_detailed.log,283312,NS.1272.002
GGATTGGT,S_20_03339,7999304,4582,739010,7255712,NS.1272.002.D706.Qilalugene-P6_detailed.log,743592,NS.1272.002
GCGT,S_20_00817,3452314,116709,303356,3032249,NS.1272.002.D706.Qilalugene-P6_detailed.log,420065,NS.1272.002
TCACG,S_20_00975,2020918,17777,268299,1734842,NS.1272.002.D706.Qilalugene-P6_detailed.log,286076,NS.1272.002
GCTTA,S_20_02715,16060298,12501,1530912,14516885,NS.1272.002.D706.Qilalugene-P6_detailed.log,1543413,NS.1272.002
GTCAA,S_20_01021,4518222,16654,390986,4110582,NS.1272.002.D706.Qilalugene-P6_detailed.log,407640,NS.1272.002
GCTCTA,S_20_00626_rep,5873840,4975,533601,5335264,NS.1272.002.D706.Qilalugene-P6_detailed.log,538576,NS.1272.002
ATCGTA,S_20_03091,15892166,12053,1920264,13959849,NS.1272.002.D706.Qilalugene-P6_detailed.log,1932317,NS.1272.002
TAACGA,S_20_01072,2638734,20258,305388,2313088,NS.1272.002.D706.Qilalugene-P6_detailed.log,325646,NS.1272.002
GGACCTA,S_20_01777,1448486,1201,156057,1291228,NS.1272.002.D706.Qilalugene-P6_detailed.log,157258,NS.1272.002
CGCTGAT,S_20_02067,5241302,2183,683257,4555862,NS.1272.002.D706.Qilalugene-P6_detailed.log,685440,NS.1272.002
ACGACTAG,S_20_01985,2546912,2436,286023,2258453,NS.1272.002.D706.Qilalugene-P6_detailed.log,288459,NS.1272.002
AACCGAGA,S_20_03597,842274,1417,93998,746859,NS.1272.002.D706.Qilalugene-P6_detailed.log,95415,NS.1272.002
GTGAGGGT,S_20_01096,865720,506,261336,603878,NS.1272.002.D706.Qilalugene-P6_detailed.log,261842,NS.1272.002
CGAT,S_20_00971,1255780,173691,177598,904491,NS.1272.002.D706.Qilalugene-P6_detailed.log,351289,NS.1272.002
CTAGG,S_20_03207,2566552,19526,273150,2273876,NS.1272.002.D706.Qilalugene-P6_detailed.log,292676,NS.1272.002
GGTGT,S_20_00914,19436976,23937,1629111,17783928,NS.1272.002.D706.Qilalugene-P6_detailed.log,1653048,NS.1272.002
TAATA,S_20_03475,715140,43033,244905,427202,NS.1272.002.D706.Qilalugene-P6_detailed.log,287938,NS.1272.002
CCACAA,S_20_01618,6453464,14841,547715,5890908,NS.1272.002.D706.Qilalugene-P6_detailed.log,562556,NS.1272.002
CATCGT,S_20_01110,26414802,20084,2263213,24131505,NS.1272.002.D706.Qilalugene-P6_detailed.log,2283297,NS.1272.002
TGGCTA,S_20_01874,2644042,3745,231617,2408680,NS.1272.002.D706.Qilalugene-P6_detailed.log,235362,NS.1272.002
GTCGATT,S_20_00687,4468968,1955,442991,4024022,NS.1272.002.D706.Qilalugene-P6_detailed.log,444946,NS.1272.002
CGGTAGA,S_20_02390,5455562,797,446731,5008034,NS.1272.002.D706.Qilalugene-P6_detailed.log,447528,NS.1272.002
TAGCATGG,S_20_01096_rep,3384052,3826,381875,2998351,NS.1272.002.D706.Qilalugene-P6_detailed.log,385701,NS.1272.002
ACAGGGA,S_20_00855,3644216,5132,336305,3302779,NS.1272.002.D706.Qilalugene-P6_detailed.log,341437,NS.1272.002
TATCGGGA,S_20_00830,5703642,5448,619671,5078523,NS.1272.002.D706.Qilalugene-P6_detailed.log,625119,NS.1272.002
GTAA,S_20_03529,1454716,126884,206248,1121584,NS.1272.002.D706.Qilalugene-P6_detailed.log,333132,NS.1272.002
ACAAA,S_20_01783,2168132,177847,290349,1699936,NS.1272.002.D706.Qilalugene-P6_detailed.log,468196,NS.1272.002
AGGAT,S_20_00868,5904796,25889,1177473,4701434,NS.1272.002.D706.Qilalugene-P6_detailed.log,1203362,NS.1272.002
TACAT,S_20_02808,6316622,50016,565954,5700652,NS.1272.002.D706.Qilalugene-P6_detailed.log,615970,NS.1272.002
CTTCCA,S_20_01865,6726898,5788,608150,6112960,NS.1272.002.D706.Qilalugene-P6_detailed.log,613938,NS.1272.002
CGCGGT,S_20_00989,3382732,2060,673328,2707344,NS.1272.002.D706.Qilalugene-P6_detailed.log,675388,NS.1272.002
TATTTTT,S_20_02375,3077216,4741,333077,2739398,NS.1272.002.D706.Qilalugene-P6_detailed.log,337818,NS.1272.002
AACGCCT,S_20_02380,3142850,1746,258951,2882153,NS.1272.002.D706.Qilalugene-P6_detailed.log,260697,NS.1272.002
CTACGGA,S_20_01801,6639262,5480,781344,5852438,NS.1272.002.D706.Qilalugene-P6_detailed.log,786824,NS.1272.002
TAGGCCAT,S_20_03584,1009348,366,109109,899873,NS.1272.002.D706.Qilalugene-P6_detailed.log,109475,NS.1272.002
ACGTGGTA,S_20_02965,2697396,3655,294390,2399351,NS.1272.002.D706.Qilalugene-P6_detailed.log,298045,NS.1272.002
TTCCTGGA,S_20_02254,6037242,4714,592476,5440052,NS.1272.002.D706.Qilalugene-P6_detailed.log,597190,NS.1272.002
CTCG,S_20_01036,2706274,110144,225159,2370971,NS.1272.002.D707.Qilalugene-P7_detailed.log,335303,NS.1272.002
AGCG,S_20_02240,3031866,199027,228286,2604553,NS.1272.002.D707.Qilalugene-P7_detailed.log,427313,NS.1272.002
TTCTG,S_20_00861_rep,10298402,16132,714162,9568108,NS.1272.002.D707.Qilalugene-P7_detailed.log,730294,NS.1272.002
ATTGA,S_20_03026,11148716,67942,928298,10152476,NS.1272.002.D707.Qilalugene-P7_detailed.log,996240,NS.1272.002
TCGTT,S_20_00872,4434992,17398,551538,3866056,NS.1272.002.D707.Qilalugene-P7_detailed.log,568936,NS.1272.002
GAGATA,S_20_01083,11623926,12464,845294,10766168,NS.1272.002.D707.Qilalugene-P7_detailed.log,857758,NS.1272.002
CTATTA,S_20_03598,4588582,11934,416007,4160641,NS.1272.002.D707.Qilalugene-P7_detailed.log,427941,NS.1272.002
CTTGCTT,S_20_01042,4903264,1579,355407,4546278,NS.1272.002.D707.Qilalugene-P7_detailed.log,356986,NS.1272.002
AATATGG,S_20_00891,13042494,22940,1150780,11868774,NS.1272.002.D707.Qilalugene-P7_detailed.log,1173720,NS.1272.002
GCGGAAT,S_20_00650,3528132,2365,324256,3201511,NS.1272.002.D707.Qilalugene-P7_detailed.log,326621,NS.1272.002
TGCAAGGA,S_20_02299,2354948,565,370144,1984239,NS.1272.002.D707.Qilalugene-P7_detailed.log,370709,NS.1272.002
CCATGGGT,S_20_03482,7746526,6882,577366,7162278,NS.1272.002.D707.Qilalugene-P7_detailed.log,584248,NS.1272.002
TGCA,S_20_01622,6236014,65852,501989,5668173,NS.1272.002.D707.Qilalugene-P7_detailed.log,567841,NS.1272.002
GATG,S_20_00641,1809262,166885,216277,1426100,NS.1272.002.D707.Qilalugene-P7_detailed.log,383162,NS.1272.002
AGCCG,S_20_00814,4833996,24571,403357,4406068,NS.1272.002.D707.Qilalugene-P7_detailed.log,427928,NS.1272.002
CATCT,S_20_00862_rep,7721754,43595,654161,7023998,NS.1272.002.D707.Qilalugene-P7_detailed.log,697756,NS.1272.002
GGTTGT,S_20_01899,8442144,7953,760397,7673794,NS.1272.002.D707.Qilalugene-P7_detailed.log,768350,NS.1272.002
ATGCCT,S_20_03658,16348400,10561,1220028,15117811,NS.1272.002.D707.Qilalugene-P7_detailed.log,1230589,NS.1272.002
GCCAGT,S_20_03094,10322296,10654,751792,9559850,NS.1272.002.D707.Qilalugene-P7_detailed.log,762446,NS.1272.002
ATGAAAG,S_20_01038,4668790,8036,425888,4234866,NS.1272.002.D707.Qilalugene-P7_detailed.log,433924,NS.1272.002
ACGTGTT,S_20_00895,6129000,8167,821672,5299161,NS.1272.002.D707.Qilalugene-P7_detailed.log,829839,NS.1272.002
TAGCGGA,S_20_03181,4928238,5721,451854,4470663,NS.1272.002.D707.Qilalugene-P7_detailed.log,457575,NS.1272.002
TGGTACGT,S_20_00854,1214712,283,121161,1093268,NS.1272.002.D707.Qilalugene-P7_detailed.log,121444,NS.1272.002
CGCGGAGA,S_20_03613,4394734,606,352121,4042007,NS.1272.002.D707.Qilalugene-P7_detailed.log,352727,NS.1272.002
ACTA,S_20_00644,2922864,208979,367118,2346767,NS.1272.002.D707.Qilalugene-P7_detailed.log,576097,NS.1272.002
TCAG,S_20_03574,1265940,59946,107963,1098031,NS.1272.002.D707.Qilalugene-P7_detailed.log,167909,NS.1272.002
GTATT,S_20_00908,5831524,17272,537065,5277187,NS.1272.002.D707.Qilalugene-P7_detailed.log,554337,NS.1272.002
CCTAG,S_20_00982,2699414,13962,396894,2288558,NS.1272.002.D707.Qilalugene-P7_detailed.log,410856,NS.1272.002
CCACGT,S_20_00921,1912734,26525,140476,1745733,NS.1272.002.D707.Qilalugene-P7_detailed.log,167001,NS.1272.002
AGTGGA,S_20_01638,8684472,38420,694142,7951910,NS.1272.002.D707.Qilalugene-P7_detailed.log,732562,NS.1272.002
GGAAGA,S_20_01774,8890174,4701,644127,8241346,NS.1272.002.D707.Qilalugene-P7_detailed.log,648828,NS.1272.002
AAAAGTT,S_20_00654,7822022,43024,587469,7191529,NS.1272.002.D707.Qilalugene-P7_detailed.log,630493,NS.1272.002
ATTAATT,S_20_00954,7357226,10271,694486,6652469,NS.1272.002.D707.Qilalugene-P7_detailed.log,704757,NS.1272.002
TCGAAGA,S_20_03230,7437208,6834,580089,6850285,NS.1272.002.D707.Qilalugene-P7_detailed.log,586923,NS.1272.002
TCTCAGTG,S_20_00871,4899682,3543,705037,4191102,NS.1272.002.D707.Qilalugene-P7_detailed.log,708580,NS.1272.002
CGTGTGGT,S_20_01882,6499606,8231,506784,5984591,NS.1272.002.D707.Qilalugene-P7_detailed.log,515015,NS.1272.002
CAGA,S_20_01620,4222304,233589,346569,3642146,NS.1272.002.D707.Qilalugene-P7_detailed.log,580158,NS.1272.002
TGCGA,S_20_00647,1618860,4563,224648,1389649,NS.1272.002.D707.Qilalugene-P7_detailed.log,229211,NS.1272.002
CTGTA,S_20_02848,8746910,23598,650241,8073071,NS.1272.002.D707.Qilalugene-P7_detailed.log,673839,NS.1272.002
GAGGA,S_20_01095_rep,5236098,54420,522559,4659119,NS.1272.002.D707.Qilalugene-P7_detailed.log,576979,NS.1272.002
TTCAGA,S_20_00860_rep,170676,1479,18826,150371,NS.1272.002.D707.Qilalugene-P7_detailed.log,20305,NS.1272.002
ACCTAA,S_20_03528,10248582,10381,760661,9477540,NS.1272.002.D707.Qilalugene-P7_detailed.log,771042,NS.1272.002
GTACTT,S_20_01948,8332840,8233,886345,7438262,NS.1272.002.D707.Qilalugene-P7_detailed.log,894578,NS.1272.002
GAATTCA,S_20_00903,3202652,3620,275104,2923928,NS.1272.002.D707.Qilalugene-P7_detailed.log,278724,NS.1272.002
ATTGGAT,S_20_01784,13188182,12838,882501,12292843,NS.1272.002.D707.Qilalugene-P7_detailed.log,895339,NS.1272.002
TCTGTGA,S_20_03617,5384968,829,410002,4974137,NS.1272.002.D707.Qilalugene-P7_detailed.log,410831,NS.1272.002
CGCGATAT,S_20_01087,8667892,2852,740657,7924383,NS.1272.002.D707.Qilalugene-P7_detailed.log,743509,NS.1272.002
GCTGTGGA,S_20_00857_rep,8180412,980,693422,7486010,NS.1272.002.D707.Qilalugene-P7_detailed.log,694402,NS.1272.002
AACT,S_20_03098,11437022,286210,742513,10408299,NS.1272.002.D707.Qilalugene-P7_detailed.log,1028723,NS.1272.002
CGCTT,S_20_00867,2272946,32127,199383,2041436,NS.1272.002.D707.Qilalugene-P7_detailed.log,231510,NS.1272.002
ACCGT,S_20_03180,2937318,34271,410501,2492546,NS.1272.002.D707.Qilalugene-P7_detailed.log,444772,NS.1272.002
GGAAG,S_20_03592,5323034,71186,422740,4829108,NS.1272.002.D707.Qilalugene-P7_detailed.log,493926,NS.1272.002
TAGGAA,S_20_02070,6107370,7673,503180,5596517,NS.1272.002.D707.Qilalugene-P7_detailed.log,510853,NS.1272.002
ATATGT,S_20_02869,3867746,30730,324986,3512030,NS.1272.002.D707.Qilalugene-P7_detailed.log,355716,NS.1272.002
GTTGAA,S_20_01766,9943684,2403,738556,9202725,NS.1272.002.D707.Qilalugene-P7_detailed.log,740959,NS.1272.002
GAACTTG,S_20_00878,2818580,20399,454513,2343668,NS.1272.002.D707.Qilalugene-P7_detailed.log,474912,NS.1272.002
CATAAGT,S_20_01786,4760138,4108,488136,4267894,NS.1272.002.D707.Qilalugene-P7_detailed.log,492244,NS.1272.002
TGCTGGA,S_20_03231,3920602,374,319265,3600963,NS.1272.002.D707.Qilalugene-P7_detailed.log,319639,NS.1272.002
CGCCTTAT,S_20_01639,8029720,3393,550171,7476156,NS.1272.002.D707.Qilalugene-P7_detailed.log,553564,NS.1272.002
GGATTGGT,S_20_03661,8674048,3019,847590,7823439,NS.1272.002.D707.Qilalugene-P7_detailed.log,850609,NS.1272.002
GCGT,S_20_01211,8210180,112127,675055,7422998,NS.1272.002.D707.Qilalugene-P7_detailed.log,787182,NS.1272.002
TCACG,S_20_02958,3887320,18196,303874,3565250,NS.1272.002.D707.Qilalugene-P7_detailed.log,322070,NS.1272.002
GCTTA,S_20_01788,9986040,18439,711536,9256065,NS.1272.002.D707.Qilalugene-P7_detailed.log,729975,NS.1272.002
GTCAA,S_20_01026,4105746,25232,567478,3513036,NS.1272.002.D707.Qilalugene-P7_detailed.log,592710,NS.1272.002
GCTCTA,S_20_01049,4243666,4243,397587,3841836,NS.1272.002.D707.Qilalugene-P7_detailed.log,401830,NS.1272.002
ATCGTA,S_20_03229,3143254,15051,371304,2756899,NS.1272.002.D707.Qilalugene-P7_detailed.log,386355,NS.1272.002
TAACGA,S_20_00651_rep,1099806,16658,192760,890388,NS.1272.002.D707.Qilalugene-P7_detailed.log,209418,NS.1272.002
GGACCTA,S_20_01061,4178716,2556,329645,3846515,NS.1272.002.D707.Qilalugene-P7_detailed.log,332201,NS.1272.002
CGCTGAT,S_20_03587,13806624,5061,1020890,12780673,NS.1272.002.D707.Qilalugene-P7_detailed.log,1025951,NS.1272.002
ACGACTAG,S_20_02633,4069702,4335,323689,3741678,NS.1272.002.D707.Qilalugene-P7_detailed.log,328024,NS.1272.002
AACCGAGA,S_20_00962,7075912,8333,641978,6425601,NS.1272.002.D707.Qilalugene-P7_detailed.log,650311,NS.1272.002
GTGAGGGT,S_20_00990,6545178,3147,464631,6077400,NS.1272.002.D707.Qilalugene-P7_detailed.log,467778,NS.1272.002
CGAT,S_20_03593,12509546,306471,886345,11316730,NS.1272.002.D707.Qilalugene-P7_detailed.log,1192816,NS.1272.002
CTAGG,S_20_01783_rep,3526928,30732,269843,3226353,NS.1272.002.D707.Qilalugene-P7_detailed.log,300575,NS.1272.002
GGTGT,S_20_02242,9821288,25757,746068,9049463,NS.1272.002.D707.Qilalugene-P7_detailed.log,771825,NS.1272.002
TAATA,S_20_03203,9410110,64211,984067,8361832,NS.1272.002.D707.Qilalugene-P7_detailed.log,1048278,NS.1272.002
CCACAA,S_20_01935,6970620,21502,547815,6401303,NS.1272.002.D707.Qilalugene-P7_detailed.log,569317,NS.1272.002
CATCGT,S_20_02716,11776628,15663,889696,10871269,NS.1272.002.D707.Qilalugene-P7_detailed.log,905359,NS.1272.002
TGGCTA,S_20_01024,1534764,2609,354045,1178110,NS.1272.002.D707.Qilalugene-P7_detailed.log,356654,NS.1272.002
GTCGATT,S_20_03102,10226608,4213,877804,9344591,NS.1272.002.D707.Qilalugene-P7_detailed.log,882017,NS.1272.002
CGGTAGA,S_20_03664,8592722,1416,522687,8068619,NS.1272.002.D707.Qilalugene-P7_detailed.log,524103,NS.1272.002
TAGCATGG,S_20_00951,1850346,2320,282694,1565332,NS.1272.002.D707.Qilalugene-P7_detailed.log,285014,NS.1272.002
ACAGGGA,S_20_00851,4199726,6234,441203,3752289,NS.1272.002.D707.Qilalugene-P7_detailed.log,447437,NS.1272.002
TATCGGGA,S_20_00963,867760,872,82838,784050,NS.1272.002.D707.Qilalugene-P7_detailed.log,83710,NS.1272.002
GTAA,S_20_01101,2112750,201821,300864,1610065,NS.1272.002.D707.Qilalugene-P7_detailed.log,502685,NS.1272.002
ACAAA,S_20_03031,1554438,207081,168707,1178650,NS.1272.002.D707.Qilalugene-P7_detailed.log,375788,NS.1272.002
AGGAT,S_20_01030,3961752,34644,542179,3384929,NS.1272.002.D707.Qilalugene-P7_detailed.log,576823,NS.1272.002
TACAT,S_20_01014,8744526,58535,799634,7886357,NS.1272.002.D707.Qilalugene-P7_detailed.log,858169,NS.1272.002
CTTCCA,S_20_01028,3354914,5973,457254,2891687,NS.1272.002.D707.Qilalugene-P7_detailed.log,463227,NS.1272.002
CGCGGT,S_20_03627,12301178,6232,910477,11384469,NS.1272.002.D707.Qilalugene-P7_detailed.log,916709,NS.1272.002
TATTTTT,S_20_00635,2327288,3435,352427,1971426,NS.1272.002.D707.Qilalugene-P7_detailed.log,355862,NS.1272.002
AACGCCT,S_20_01111,1095070,1633,281693,811744,NS.1272.002.D707.Qilalugene-P7_detailed.log,283326,NS.1272.002
CTACGGA,S_20_03197,3845722,3506,352184,3490032,NS.1272.002.D707.Qilalugene-P7_detailed.log,355690,NS.1272.002
TAGGCCAT,S_20_00898,2173766,815,256965,1915986,NS.1272.002.D707.Qilalugene-P7_detailed.log,257780,NS.1272.002
ACGTGGTA,S_20_02959,4328648,4394,371195,3953059,NS.1272.002.D707.Qilalugene-P7_detailed.log,375589,NS.1272.002
TTCCTGGA,S_20_01020,3603160,2685,308719,3291756,NS.1272.002.D707.Qilalugene-P7_detailed.log,311404,NS.1272.002
CTCG,S_20_02394,4987494,73345,205460,4708689,NS.1272.002.D708.Qilalugene-P8_detailed.log,278805,NS.1272.002
AGCG,S_20_03195,8599562,180460,293136,8125966,NS.1272.002.D708.Qilalugene-P8_detailed.log,473596,NS.1272.002
TTCTG,S_20_03601,9830914,18743,341264,9470907,NS.1272.002.D708.Qilalugene-P8_detailed.log,360007,NS.1272.002
ATTGA,S_20_01031,1534626,22599,138587,1373440,NS.1272.002.D708.Qilalugene-P8_detailed.log,161186,NS.1272.002
TCGTT,S_20_00683,2824164,11298,215508,2597358,NS.1272.002.D708.Qilalugene-P8_detailed.log,226806,NS.1272.002
GAGATA,S_20_01119,6961200,7420,302896,6650884,NS.1272.002.D708.Qilalugene-P8_detailed.log,310316,NS.1272.002
CTATTA,S_20_01019_rep,5293494,8131,343505,4941858,NS.1272.002.D708.Qilalugene-P8_detailed.log,351636,NS.1272.002
CTTGCTT,S_20_01944_rep,3889896,989,235400,3653507,NS.1272.002.D708.Qilalugene-P8_detailed.log,236389,NS.1272.002
AATATGG,S_20_01029,2081460,6473,237970,1837017,NS.1272.002.D708.Qilalugene-P8_detailed.log,244443,NS.1272.002
GCGGAAT,S_20_03055,5650138,2176,209216,5438746,NS.1272.002.D708.Qilalugene-P8_detailed.log,211392,NS.1272.002
TGCAAGGA,S_20_01073,1142220,507,156301,985412,NS.1272.002.D708.Qilalugene-P8_detailed.log,156808,NS.1272.002
CCATGGGT,S_20_03119,9634408,10085,323825,9300498,NS.1272.002.D708.Qilalugene-P8_detailed.log,333910,NS.1272.002
TGCA,S_20_02365,5254216,82022,205291,4966903,NS.1272.002.D708.Qilalugene-P8_detailed.log,287313,NS.1272.002
GATG,S_20_00657,3584248,136212,135499,3312537,NS.1272.002.D708.Qilalugene-P8_detailed.log,271711,NS.1272.002
AGCCG,S_20_02109,6069058,19099,228613,5821346,NS.1272.002.D708.Qilalugene-P8_detailed.log,247712,NS.1272.002
CATCT,S_20_02069,2626328,31369,191887,2403072,NS.1272.002.D708.Qilalugene-P8_detailed.log,223256,NS.1272.002
GGTTGT,S_20_00852_rep,3812416,4285,165280,3642851,NS.1272.002.D708.Qilalugene-P8_detailed.log,169565,NS.1272.002
ATGCCT,S_20_00650_rep,1168850,1682,119033,1048135,NS.1272.002.D708.Qilalugene-P8_detailed.log,120715,NS.1272.002
GCCAGT,S_20_01074,7552312,8368,229064,7314880,NS.1272.002.D708.Qilalugene-P8_detailed.log,237432,NS.1272.002
ATGAAAG,S_20_00865,9126476,11201,328293,8786982,NS.1272.002.D708.Qilalugene-P8_detailed.log,339494,NS.1272.002
ACGTGTT,S_20_03632,2442542,3314,132944,2306284,NS.1272.002.D708.Qilalugene-P8_detailed.log,136258,NS.1272.002
TAGCGGA,S_20_01012_rep,6360820,8753,280871,6071196,NS.1272.002.D708.Qilalugene-P8_detailed.log,289624,NS.1272.002
TGGTACGT,S_20_01137,9567014,2599,352809,9211606,NS.1272.002.D708.Qilalugene-P8_detailed.log,355408,NS.1272.002
CGCGGAGA,S_20_01767,5380312,818,172475,5207019,NS.1272.002.D708.Qilalugene-P8_detailed.log,173293,NS.1272.002
ACTA,S_20_01060,1795748,155765,67278,1572705,NS.1272.002.D708.Qilalugene-P8_detailed.log,223043,NS.1272.002
TCAG,S_20_00968,1796614,53530,129037,1614047,NS.1272.002.D708.Qilalugene-P8_detailed.log,182567,NS.1272.002
GTATT,S_20_02917,6332212,12779,260150,6059283,NS.1272.002.D708.Qilalugene-P8_detailed.log,272929,NS.1272.002
CCTAG,S_20_02609,8969836,12916,280245,8676675,NS.1272.002.D708.Qilalugene-P8_detailed.log,293161,NS.1272.002
CCACGT,S_20_00961,3549104,40742,116409,3391953,NS.1272.002.D708.Qilalugene-P8_detailed.log,157151,NS.1272.002
AGTGGA,S_20_00853,5465888,3465,242919,5219504,NS.1272.002.D708.Qilalugene-P8_detailed.log,246384,NS.1272.002
GGAAGA,S_20_03614,4737764,1953,170997,4564814,NS.1272.002.D708.Qilalugene-P8_detailed.log,172950,NS.1272.002
AAAAGTT,S_20_01621,4645566,26707,220284,4398575,NS.1272.002.D708.Qilalugene-P8_detailed.log,246991,NS.1272.002
ATTAATT,S_20_02389,2275850,2256,109153,2164441,NS.1272.002.D708.Qilalugene-P8_detailed.log,111409,NS.1272.002
TCGAAGA,S_20_01624,11683910,9885,433658,11240367,NS.1272.002.D708.Qilalugene-P8_detailed.log,443543,NS.1272.002
TCTCAGTG,S_20_02636,10141776,6393,367065,9768318,NS.1272.002.D708.Qilalugene-P8_detailed.log,373458,NS.1272.002
CGTGTGGT,S_20_01066,2706908,2838,120032,2584038,NS.1272.002.D708.Qilalugene-P8_detailed.log,122870,NS.1272.002
CAGA,S_20_02110,3235608,144521,123198,2967889,NS.1272.002.D708.Qilalugene-P8_detailed.log,267719,NS.1272.002
TGCGA,S_20_00646_rep,4444192,4598,240457,4199137,NS.1272.002.D708.Qilalugene-P8_detailed.log,245055,NS.1272.002
CTGTA,S_20_01085,829978,17108,105143,707727,NS.1272.002.D708.Qilalugene-P8_detailed.log,122251,NS.1272.002
GAGGA,S_20_02252,5603842,51875,194575,5357392,NS.1272.002.D708.Qilalugene-P8_detailed.log,246450,NS.1272.002
TTCAGA,S_20_00824,1285720,1383,110297,1174040,NS.1272.002.D708.Qilalugene-P8_detailed.log,111680,NS.1272.002
ACCTAA,S_20_03478,8472234,9047,337937,8125250,NS.1272.002.D708.Qilalugene-P8_detailed.log,346984,NS.1272.002
GTACTT,S_20_01081,7691538,6065,288148,7397325,NS.1272.002.D708.Qilalugene-P8_detailed.log,294213,NS.1272.002
GAATTCA,S_20_03481,3311650,3194,256567,3051889,NS.1272.002.D708.Qilalugene-P8_detailed.log,259761,NS.1272.002
ATTGGAT,S_20_01097_rep,632554,3485,94274,534795,NS.1272.002.D708.Qilalugene-P8_detailed.log,97759,NS.1272.002
TCTGTGA,S_20_03590,4406014,553,156509,4248952,NS.1272.002.D708.Qilalugene-P8_detailed.log,157062,NS.1272.002
CGCGATAT,S_20_02913,7563780,1927,254075,7307778,NS.1272.002.D708.Qilalugene-P8_detailed.log,256002,NS.1272.002
GCTGTGGA,S_20_01939,8158856,970,247497,7910389,NS.1272.002.D708.Qilalugene-P8_detailed.log,248467,NS.1272.002
AACT,S_20_01145,3596894,229756,189548,3177590,NS.1272.002.D708.Qilalugene-P8_detailed.log,419304,NS.1272.002
CGCTT,S_20_03575,9158974,22423,281598,8854953,NS.1272.002.D708.Qilalugene-P8_detailed.log,304021,NS.1272.002
ACCGT,S_20_01785,5941772,44089,212879,5684804,NS.1272.002.D708.Qilalugene-P8_detailed.log,256968,NS.1272.002
GGAAG,S_20_01635,2246606,35729,138475,2072402,NS.1272.002.D708.Qilalugene-P8_detailed.log,174204,NS.1272.002
TAGGAA,S_20_02068,3407366,7716,116833,3282817,NS.1272.002.D708.Qilalugene-P8_detailed.log,124549,NS.1272.002
ATATGT,S_20_00921_rep,3258522,25112,198056,3035354,NS.1272.002.D708.Qilalugene-P8_detailed.log,223168,NS.1272.002
GTTGAA,S_20_01093,6117988,1406,189400,5927182,NS.1272.002.D708.Qilalugene-P8_detailed.log,190806,NS.1272.002
GAACTTG,S_20_00835_rep,1439906,15581,171659,1252666,NS.1272.002.D708.Qilalugene-P8_detailed.log,187240,NS.1272.002
CATAAGT,S_20_00620,2271312,1871,161687,2107754,NS.1272.002.D708.Qilalugene-P8_detailed.log,163558,NS.1272.002
TGCTGGA,S_20_02173,5810654,595,224422,5585637,NS.1272.002.D708.Qilalugene-P8_detailed.log,225017,NS.1272.002
CGCCTTAT,S_20_00907,4165996,1951,248206,3915839,NS.1272.002.D708.Qilalugene-P8_detailed.log,250157,NS.1272.002
GGATTGGT,S_20_00969,2087856,923,162265,1924668,NS.1272.002.D708.Qilalugene-P8_detailed.log,163188,NS.1272.002
GCGT,S_20_03476_rep,5282644,90362,184655,5007627,NS.1272.002.D708.Qilalugene-P8_detailed.log,275017,NS.1272.002
TCACG,S_20_01775,6919982,28985,283456,6607541,NS.1272.002.D708.Qilalugene-P8_detailed.log,312441,NS.1272.002
GCTTA,S_20_03028,7077046,15056,257184,6804806,NS.1272.002.D708.Qilalugene-P8_detailed.log,272240,NS.1272.002
GTCAA,S_20_01949,1525802,14817,147549,1363436,NS.1272.002.D708.Qilalugene-P8_detailed.log,162366,NS.1272.002
GCTCTA,S_20_00647_rep,3261048,3681,131743,3125624,NS.1272.002.D708.Qilalugene-P8_detailed.log,135424,NS.1272.002
ATCGTA,S_20_03027,10305232,8057,382254,9914921,NS.1272.002.D708.Qilalugene-P8_detailed.log,390311,NS.1272.002
TAACGA,S_20_01135,10183084,40812,355228,9787044,NS.1272.002.D708.Qilalugene-P8_detailed.log,396040,NS.1272.002
GGACCTA,S_20_01105,2273754,1425,148051,2124278,NS.1272.002.D708.Qilalugene-P8_detailed.log,149476,NS.1272.002
CGCTGAT,S_20_01079,4698254,2854,172882,4522518,NS.1272.002.D708.Qilalugene-P8_detailed.log,175736,NS.1272.002
ACGACTAG,S_20_01016,6287144,4727,230168,6052249,NS.1272.002.D708.Qilalugene-P8_detailed.log,234895,NS.1272.002
AACCGAGA,S_20_02387,7271722,8145,249320,7014257,NS.1272.002.D708.Qilalugene-P8_detailed.log,257465,NS.1272.002
GTGAGGGT,S_20_00659,684178,436,84896,598846,NS.1272.002.D708.Qilalugene-P8_detailed.log,85332,NS.1272.002
CGAT,S_20_01762,2288132,187210,128516,1972406,NS.1272.002.D708.Qilalugene-P8_detailed.log,315726,NS.1272.002
CTAGG,S_20_02809,5714412,30790,214187,5469435,NS.1272.002.D708.Qilalugene-P8_detailed.log,244977,NS.1272.002
GGTGT,S_20_03202,7527600,18272,316936,7192392,NS.1272.002.D708.Qilalugene-P8_detailed.log,335208,NS.1272.002
TAATA,S_20_00902,1117512,48511,47569,1021432,NS.1272.002.D708.Qilalugene-P8_detailed.log,96080,NS.1272.002
CCACAA,S_20_00930,2745258,11874,101704,2631680,NS.1272.002.D708.Qilalugene-P8_detailed.log,113578,NS.1272.002
CATCGT,S_20_01000,2227802,14007,158732,2055063,NS.1272.002.D708.Qilalugene-P8_detailed.log,172739,NS.1272.002
TGGCTA,S_20_01047,1647216,4548,68649,1574019,NS.1272.002.D708.Qilalugene-P8_detailed.log,73197,NS.1272.002
GTCGATT,S_20_03476,3157900,1016,117167,3039717,NS.1272.002.D708.Qilalugene-P8_detailed.log,118183,NS.1272.002
CGGTAGA,S_20_01051,5915246,793,179954,5734499,NS.1272.002.D708.Qilalugene-P8_detailed.log,180747,NS.1272.002
TAGCATGG,S_20_01112,3601038,3880,191812,3405346,NS.1272.002.D708.Qilalugene-P8_detailed.log,195692,NS.1272.002
ACAGGGA,S_20_00658,5917904,7868,194365,5715671,NS.1272.002.D708.Qilalugene-P8_detailed.log,202233,NS.1272.002
TATCGGGA,S_20_00851_rep,8947318,8988,344955,8593375,NS.1272.002.D708.Qilalugene-P8_detailed.log,353943,NS.1272.002
GTAA,S_20_01104,1096608,107876,84775,903957,NS.1272.002.D708.Qilalugene-P8_detailed.log,192651,NS.1272.002
ACAAA,S_20_01781,6334968,155696,212958,5966314,NS.1272.002.D708.Qilalugene-P8_detailed.log,368654,NS.1272.002
AGGAT,S_20_01021_rep,3986704,23209,195520,3767975,NS.1272.002.D708.Qilalugene-P8_detailed.log,218729,NS.1272.002
TACAT,S_20_01763,7674758,57819,285391,7331548,NS.1272.002.D708.Qilalugene-P8_detailed.log,343210,NS.1272.002
CTTCCA,S_20_00890,3704132,3795,108501,3591836,NS.1272.002.D708.Qilalugene-P8_detailed.log,112296,NS.1272.002
CGCGGT,S_20_01769,7825552,4484,222010,7599058,NS.1272.002.D708.Qilalugene-P8_detailed.log,226494,NS.1272.002
TATTTTT,S_20_02664,5135172,5700,167365,4962107,NS.1272.002.D708.Qilalugene-P8_detailed.log,173065,NS.1272.002
AACGCCT,S_20_00853_rep,2746294,1782,157767,2586745,NS.1272.002.D708.Qilalugene-P8_detailed.log,159549,NS.1272.002
CTACGGA,S_20_01139,3477616,3297,194444,3279875,NS.1272.002.D708.Qilalugene-P8_detailed.log,197741,NS.1272.002
TAGGCCAT,S_20_03665_rep,3043548,1108,178701,2863739,NS.1272.002.D708.Qilalugene-P8_detailed.log,179809,NS.1272.002
ACGTGGTA,S_20_03542,2212098,1997,136858,2073243,NS.1272.002.D708.Qilalugene-P8_detailed.log,138855,NS.1272.002
TTCCTGGA,S_20_00684,6829802,5574,230723,6593505,NS.1272.002.D708.Qilalugene-P8_detailed.log,236297,NS.1272.002
CTCG,S_20_02714,1930400,25089,258115,1647196,NS.1272.002.D709.Qilalugene-P9_detailed.log,283204,NS.1272.002
AGCG,S_20_01048,8961674,34502,879334,8047838,NS.1272.002.D709.Qilalugene-P9_detailed.log,913836,NS.1272.002
TTCTG,S_20_02612,5548830,4100,720041,4824689,NS.1272.002.D709.Qilalugene-P9_detailed.log,724141,NS.1272.002
ATTGA,S_20_00991,1939382,9195,370546,1559641,NS.1272.002.D709.Qilalugene-P9_detailed.log,379741,NS.1272.002
TCGTT,S_20_00681,4929734,6187,575686,4347861,NS.1272.002.D709.Qilalugene-P9_detailed.log,581873,NS.1272.002
GAGATA,S_20_01866,8831588,4406,1024983,7802199,NS.1272.002.D709.Qilalugene-P9_detailed.log,1029389,NS.1272.002
TGCA,S_20_01134,3984790,29682,356365,3598743,NS.1272.002.D709.Qilalugene-P9_detailed.log,386047,NS.1272.002
GATG,S_20_00977,6337402,49552,796980,5490870,NS.1272.002.D709.Qilalugene-P9_detailed.log,846532,NS.1272.002
AGCCG,S_20_02391,9086706,7606,913631,8165469,NS.1272.002.D709.Qilalugene-P9_detailed.log,921237,NS.1272.002
CATCT,S_20_03508,7355174,24154,856916,6474104,NS.1272.002.D709.Qilalugene-P9_detailed.log,881070,NS.1272.002
GGTTGT,S_20_00822,4032728,1770,627674,3403284,NS.1272.002.D709.Qilalugene-P9_detailed.log,629444,NS.1272.002
ATGCCT,S_20_03229_rep,2535806,1667,377355,2156784,NS.1272.002.D709.Qilalugene-P9_detailed.log,379022,NS.1272.002
ACTA,S_20_03185,2975906,67833,578870,2329203,NS.1272.002.D709.Qilalugene-P9_detailed.log,646703,NS.1272.002
TCAG,S_20_03606,2546022,27766,298787,2219469,NS.1272.002.D709.Qilalugene-P9_detailed.log,326553,NS.1272.002
GTATT,S_20_01765,12158864,13520,1148561,10996783,NS.1272.002.D709.Qilalugene-P9_detailed.log,1162081,NS.1272.002
CCTAG,S_20_01864,7820862,2773,748901,7069188,NS.1272.002.D709.Qilalugene-P9_detailed.log,751674,NS.1272.002
CCACGT,S_20_01045,1435214,29079,163619,1242516,NS.1272.002.D709.Qilalugene-P9_detailed.log,192698,NS.1272.002
AGTGGA,S_20_00835_rep_1,1522624,3303,385915,1133406,NS.1272.002.D709.Qilalugene-P9_detailed.log,389218,NS.1272.002
CAGA,S_20_02916,4378898,89088,448003,3841807,NS.1272.002.D709.Qilalugene-P9_detailed.log,537091,NS.1272.002
TGCGA,S_20_03662,11500052,1715,1223049,10275288,NS.1272.002.D709.Qilalugene-P9_detailed.log,1224764,NS.1272.002
CTGTA,S_20_00892,5305046,4012,770795,4530239,NS.1272.002.D709.Qilalugene-P9_detailed.log,774807,NS.1272.002
GAGGA,S_20_01001,2859872,12083,653234,2194555,NS.1272.002.D709.Qilalugene-P9_detailed.log,665317,NS.1272.002
TTCAGA,S_20_00928,3716544,1240,443025,3272279,NS.1272.002.D709.Qilalugene-P9_detailed.log,444265,NS.1272.002
AACT,S_20_01623,8590338,80689,806483,7703166,NS.1272.002.D709.Qilalugene-P9_detailed.log,887172,NS.1272.002
CGCTT,S_20_00916_rep,6689654,8114,757742,5923798,NS.1272.002.D709.Qilalugene-P9_detailed.log,765856,NS.1272.002
ACCGT,S_20_00894,2069864,22022,492942,1554900,NS.1272.002.D709.Qilalugene-P9_detailed.log,514964,NS.1272.002
GGAAG,S_20_01103,7288288,16580,952550,6319158,NS.1272.002.D709.Qilalugene-P9_detailed.log,969130,NS.1272.002
TAGGAA,S_20_01003,2807252,1743,596458,2209051,NS.1272.002.D709.Qilalugene-P9_detailed.log,598201,NS.1272.002
GCGT,S_20_00960,3577202,51735,597000,2928467,NS.1272.002.D709.Qilalugene-P9_detailed.log,648735,NS.1272.002
TCACG,S_20_02727,11020684,14022,1333086,9673576,NS.1272.002.D709.Qilalugene-P9_detailed.log,1347108,NS.1272.002
GCTTA,S_20_00854_rep,9339304,3921,1218577,8116806,NS.1272.002.D709.Qilalugene-P9_detailed.log,1222498,NS.1272.002
GTCAA,S_20_01136,11550636,9765,1245724,10295147,NS.1272.002.D709.Qilalugene-P9_detailed.log,1255489,NS.1272.002
GCTCTA,S_20_00929,7164030,3837,794158,6366035,NS.1272.002.D709.Qilalugene-P9_detailed.log,797995,NS.1272.002
CGAT,S_20_01106,2290446,70081,398473,1821892,NS.1272.002.D709.Qilalugene-P9_detailed.log,468554,NS.1272.002
CTAGG,S_20_01933,9459132,18287,965576,8475269,NS.1272.002.D709.Qilalugene-P9_detailed.log,983863,NS.1272.002
GGTGT,S_20_03084,13460120,16018,1469651,11974451,NS.1272.002.D709.Qilalugene-P9_detailed.log,1485669,NS.1272.002
TAATA,S_20_02083,1782940,21890,270882,1490168,NS.1272.002.D709.Qilalugene-P9_detailed.log,292772,NS.1272.002
CCACAA,S_20_01063,10883774,11961,1037303,9834510,NS.1272.002.D709.Qilalugene-P9_detailed.log,1049264,NS.1272.002
GTAA,S_20_02393,5653402,80154,655870,4917378,NS.1272.002.D709.Qilalugene-P9_detailed.log,736024,NS.1272.002
ACAAA,S_20_03663,10711816,79997,1234467,9397352,NS.1272.002.D709.Qilalugene-P9_detailed.log,1314464,NS.1272.002
AGGAT,S_20_01091,1924830,13783,494958,1416089,NS.1272.002.D709.Qilalugene-P9_detailed.log,508741,NS.1272.002
TACAT,S_20_00927,5607240,25658,753243,4828339,NS.1272.002.D709.Qilalugene-P9_detailed.log,778901,NS.1272.002
CTTCCA,S_20_00897,2693770,1793,615679,2076298,NS.1272.002.D709.Qilalugene-P9_detailed.log,617472,NS.1272.002
CTCG,S_20_00730,2616142,77975,714678,1823489,NS.1272.003.D701.Qilalugene-P1_detailed.log,792653,NS.1272.003
AGCG,S_20_00618,6332676,163288,1609095,4560293,NS.1272.003.D701.Qilalugene-P1_detailed.log,1772383,NS.1272.003
TTCTG,S_20_00778,5761834,19855,1546771,4195208,NS.1272.003.D701.Qilalugene-P1_detailed.log,1566626,NS.1272.003
ATTGA,S_20_00631,833952,34420,273341,526191,NS.1272.003.D701.Qilalugene-P1_detailed.log,307761,NS.1272.003
TCGTT,S_20_00786,1680658,6706,272809,1401143,NS.1272.003.D701.Qilalugene-P1_detailed.log,279515,NS.1272.003
GAGATA,S_20_00601,9991874,8316,2780844,7202714,NS.1272.003.D701.Qilalugene-P1_detailed.log,2789160,NS.1272.003
CTATTA,S_20_01215,2728072,8194,678932,2040946,NS.1272.003.D701.Qilalugene-P1_detailed.log,687126,NS.1272.003
CTTGCTT,S_20_00605,4470770,1277,1332232,3137261,NS.1272.003.D701.Qilalugene-P1_detailed.log,1333509,NS.1272.003
AATATGG,S_20_00607,4714398,11044,1560143,3143211,NS.1272.003.D701.Qilalugene-P1_detailed.log,1571187,NS.1272.003
GCGGAAT,S_20_00600,8413348,3029,2369708,6040611,NS.1272.003.D701.Qilalugene-P1_detailed.log,2372737,NS.1272.003
TGCAAGGA,S_20_00807,9602588,1349,2743008,6858231,NS.1272.003.D701.Qilalugene-P1_detailed.log,2744357,NS.1272.003
CCATGGGT,S_20_00662,7887876,11395,2352634,5523847,NS.1272.003.D701.Qilalugene-P1_detailed.log,2364029,NS.1272.003
TGCA,S_20_00732,2531486,243137,751687,1536662,NS.1272.003.D701.Qilalugene-P1_detailed.log,994824,NS.1272.003
GATG,S_20_01214,5267000,107685,1674347,3484968,NS.1272.003.D701.Qilalugene-P1_detailed.log,1782032,NS.1272.003
AGCCG,S_20_00901,3187632,15261,984440,2187931,NS.1272.003.D701.Qilalugene-P1_detailed.log,999701,NS.1272.003
CATCT,S_20_00805,4878142,34732,1584104,3259306,NS.1272.003.D701.Qilalugene-P1_detailed.log,1618836,NS.1272.003
GGTTGT,S_20_01217,1942522,4611,825527,1112384,NS.1272.003.D701.Qilalugene-P1_detailed.log,830138,NS.1272.003
ATGCCT,S_20_00625,11387486,7167,3091702,8288617,NS.1272.003.D701.Qilalugene-P1_detailed.log,3098869,NS.1272.003
GCCAGT,S_20_00769,7836732,9231,3051548,4775953,NS.1272.003.D701.Qilalugene-P1_detailed.log,3060779,NS.1272.003
ATGAAAG,S_20_03515,3795158,5297,1506886,2282975,NS.1272.003.D701.Qilalugene-P1_detailed.log,1512183,NS.1272.003
ACGTGTT,S_20_00800,4276484,5551,1466511,2804422,NS.1272.003.D701.Qilalugene-P1_detailed.log,1472062,NS.1272.003
TAGCGGA,S_20_00797,9892288,32816,2758951,7100521,NS.1272.003.D701.Qilalugene-P1_detailed.log,2791767,NS.1272.003
TGGTACGT,S_20_00703,3753378,1073,1334026,2418279,NS.1272.003.D701.Qilalugene-P1_detailed.log,1335099,NS.1272.003
CGCGGAGA,S_20_03448,9762356,1850,2763028,6997478,NS.1272.003.D701.Qilalugene-P1_detailed.log,2764878,NS.1272.003
ACTA,S_20_00624,1203164,152055,323072,728037,NS.1272.003.D701.Qilalugene-P1_detailed.log,475127,NS.1272.003
TCAG,S_20_00626,3445568,52943,874133,2518492,NS.1272.003.D701.Qilalugene-P1_detailed.log,927076,NS.1272.003
GTATT,S_20_00670,5831730,13179,1752371,4066180,NS.1272.003.D701.Qilalugene-P1_detailed.log,1765550,NS.1272.003
CCTAG,S_20_00744,5662142,9120,1693010,3960012,NS.1272.003.D701.Qilalugene-P1_detailed.log,1702130,NS.1272.003
CCACGT,S_20_00767,3137236,16769,956767,2163700,NS.1272.003.D701.Qilalugene-P1_detailed.log,973536,NS.1272.003
AGTGGA,S_20_03522,7320966,18267,2168071,5134628,NS.1272.003.D701.Qilalugene-P1_detailed.log,2186338,NS.1272.003
GGAAGA,S_20_00671,1128242,3182,355134,769926,NS.1272.003.D701.Qilalugene-P1_detailed.log,358316,NS.1272.003
AAAAGTT,S_20_00699,9682390,46473,2938031,6697886,NS.1272.003.D701.Qilalugene-P1_detailed.log,2984504,NS.1272.003
ATTAATT,S_20_00606,8146428,7561,2440272,5698595,NS.1272.003.D701.Qilalugene-P1_detailed.log,2447833,NS.1272.003
TCGAAGA,S_20_03519,5546226,4073,1503027,4039126,NS.1272.003.D701.Qilalugene-P1_detailed.log,1507100,NS.1272.003
TCTCAGTG,S_20_00784,3288892,2301,1139943,2146648,NS.1272.003.D701.Qilalugene-P1_detailed.log,1142244,NS.1272.003
CGTGTGGT,S_20_00742,7398802,7667,1998836,5392299,NS.1272.003.D701.Qilalugene-P1_detailed.log,2006503,NS.1272.003
CAGA,S_20_00768,3937696,180940,1141663,2615093,NS.1272.003.D701.Qilalugene-P1_detailed.log,1322603,NS.1272.003
TGCGA,S_20_00755,4206226,3413,1321082,2881731,NS.1272.003.D701.Qilalugene-P1_detailed.log,1324495,NS.1272.003
CTGTA,S_20_00741,3349198,9280,1008175,2331743,NS.1272.003.D701.Qilalugene-P1_detailed.log,1017455,NS.1272.003
GAGGA,S_20_00789,4439554,61752,1403496,2974306,NS.1272.003.D701.Qilalugene-P1_detailed.log,1465248,NS.1272.003
TTCAGA,S_20_00615,8700548,3878,2333639,6363031,NS.1272.003.D701.Qilalugene-P1_detailed.log,2337517,NS.1272.003
ACCTAA,S_20_00735,8175662,8754,3113888,5053020,NS.1272.003.D701.Qilalugene-P1_detailed.log,3122642,NS.1272.003
GTACTT,S_20_03517,6942662,6875,2118478,4817309,NS.1272.003.D701.Qilalugene-P1_detailed.log,2125353,NS.1272.003
GAATTCA,S_20_00811,9487478,6365,2933276,6547837,NS.1272.003.D701.Qilalugene-P1_detailed.log,2939641,NS.1272.003
ATTGGAT,S_20_00724,8704108,5980,2862273,5835855,NS.1272.003.D701.Qilalugene-P1_detailed.log,2868253,NS.1272.003
TCTGTGA,S_20_00806,3071878,438,1181040,1890400,NS.1272.003.D701.Qilalugene-P1_detailed.log,1181478,NS.1272.003
CGCGATAT,S_20_00665,3909992,1064,1071425,2837503,NS.1272.003.D701.Qilalugene-P1_detailed.log,1072489,NS.1272.003
GCTGTGGA,S_20_00738,5371836,758,1615300,3755778,NS.1272.003.D701.Qilalugene-P1_detailed.log,1616058,NS.1272.003
AACT,S_20_00801,3632570,221761,942928,2467881,NS.1272.003.D701.Qilalugene-P1_detailed.log,1164689,NS.1272.003
CGCTT,S_20_00692,3207942,16329,884199,2307414,NS.1272.003.D701.Qilalugene-P1_detailed.log,900528,NS.1272.003
ACCGT,S_20_00622,12347092,32069,3562166,8752857,NS.1272.003.D701.Qilalugene-P1_detailed.log,3594235,NS.1272.003
GGAAG,S_20_03506,7390034,42566,1993610,5353858,NS.1272.003.D701.Qilalugene-P1_detailed.log,2036176,NS.1272.003
TAGGAA,S_20_01219,3580036,12011,817574,2750451,NS.1272.003.D701.Qilalugene-P1_detailed.log,829585,NS.1272.003
ATATGT,S_20_00604,9526936,25477,2838844,6662615,NS.1272.003.D701.Qilalugene-P1_detailed.log,2864321,NS.1272.003
GTTGAA,S_20_03452,8432434,1576,2516226,5914632,NS.1272.003.D701.Qilalugene-P1_detailed.log,2517802,NS.1272.003
GAACTTG,S_20_01221,3571310,13187,850316,2707807,NS.1272.003.D701.Qilalugene-P1_detailed.log,863503,NS.1272.003
CATAAGT,S_20_00725,9865990,5548,3463609,6396833,NS.1272.003.D701.Qilalugene-P1_detailed.log,3469157,NS.1272.003
TGCTGGA,S_20_00666,9717018,991,2960543,6755484,NS.1272.003.D701.Qilalugene-P1_detailed.log,2961534,NS.1272.003
CGCCTTAT,S_20_00765,4501390,1977,1297648,3201765,NS.1272.003.D701.Qilalugene-P1_detailed.log,1299625,NS.1272.003
GGATTGGT,S_20_00718,9711406,3523,2904607,6803276,NS.1272.003.D701.Qilalugene-P1_detailed.log,2908130,NS.1272.003
GCGT,S_20_00721,2128950,66515,645709,1416726,NS.1272.003.D701.Qilalugene-P1_detailed.log,712224,NS.1272.003
TCACG,S_20_00623,1290176,13466,391154,885556,NS.1272.003.D701.Qilalugene-P1_detailed.log,404620,NS.1272.003
GCTTA,S_20_00712,5287234,8325,1613974,3664935,NS.1272.003.D701.Qilalugene-P1_detailed.log,1622299,NS.1272.003
GTCAA,S_20_00804,6342276,24457,1679672,4638147,NS.1272.003.D701.Qilalugene-P1_detailed.log,1704129,NS.1272.003
GCTCTA,S_20_00780,5619332,3861,1614118,4001353,NS.1272.003.D701.Qilalugene-P1_detailed.log,1617979,NS.1272.003
ATCGTA,S_20_00729,9103738,12543,3684706,5406489,NS.1272.003.D701.Qilalugene-P1_detailed.log,3697249,NS.1272.003
TAACGA,S_20_00792,8668100,32468,2381384,6254248,NS.1272.003.D701.Qilalugene-P1_detailed.log,2413852,NS.1272.003
GGACCTA,S_20_03510,2101552,1059,819148,1281345,NS.1272.003.D701.Qilalugene-P1_detailed.log,820207,NS.1272.003
CGCTGAT,S_20_00757,4409740,2968,1432380,2974392,NS.1272.003.D701.Qilalugene-P1_detailed.log,1435348,NS.1272.003
ACGACTAG,S_20_03514,8639268,6552,2478943,6153773,NS.1272.003.D701.Qilalugene-P1_detailed.log,2485495,NS.1272.003
AACCGAGA,S_20_00663,1358202,2074,466208,889920,NS.1272.003.D701.Qilalugene-P1_detailed.log,468282,NS.1272.003
GTGAGGGT,S_20_00667,11637586,5514,3266470,8365602,NS.1272.003.D701.Qilalugene-P1_detailed.log,3271984,NS.1272.003
CGAT,S_20_00803,4814228,175914,1228311,3410003,NS.1272.003.D701.Qilalugene-P1_detailed.log,1404225,NS.1272.003
CTAGG,S_20_00754,8301972,32120,2963384,5306468,NS.1272.003.D701.Qilalugene-P1_detailed.log,2995504,NS.1272.003
GGTGT,S_20_00630,5981366,17056,1642832,4321478,NS.1272.003.D701.Qilalugene-P1_detailed.log,1659888,NS.1272.003
TAATA,S_20_00802,4968564,50665,1539977,3377922,NS.1272.003.D701.Qilalugene-P1_detailed.log,1590642,NS.1272.003
CCACAA,S_20_00749,10490028,20252,3338361,7131415,NS.1272.003.D701.Qilalugene-P1_detailed.log,3358613,NS.1272.003
CATCGT,S_20_00621,2235618,10725,664464,1560429,NS.1272.003.D701.Qilalugene-P1_detailed.log,675189,NS.1272.003
TGGCTA,S_20_00717,3693274,6642,1440989,2245643,NS.1272.003.D701.Qilalugene-P1_detailed.log,1447631,NS.1272.003
GTCGATT,S_20_00701,8360154,2645,2358478,5999031,NS.1272.003.D701.Qilalugene-P1_detailed.log,2361123,NS.1272.003
CGGTAGA,S_20_01218,1609538,658,479388,1129492,NS.1272.003.D701.Qilalugene-P1_detailed.log,480046,NS.1272.003
TAGCATGG,S_20_01216,3057648,3006,746981,2307661,NS.1272.003.D701.Qilalugene-P1_detailed.log,749987,NS.1272.003
ACAGGGA,S_20_00790,5853838,7153,1706666,4140019,NS.1272.003.D701.Qilalugene-P1_detailed.log,1713819,NS.1272.003
TATCGGGA,S_20_00762,11696340,11761,3644824,8039755,NS.1272.003.D701.Qilalugene-P1_detailed.log,3656585,NS.1272.003
GTAA,S_20_00700,1258310,167561,286995,803754,NS.1272.003.D701.Qilalugene-P1_detailed.log,454556,NS.1272.003
ACAAA,S_20_00653,7190706,164507,2087409,4938790,NS.1272.003.D701.Qilalugene-P1_detailed.log,2251916,NS.1272.003
AGGAT,S_20_00720,7413724,25198,2005091,5383435,NS.1272.003.D701.Qilalugene-P1_detailed.log,2030289,NS.1272.003
TACAT,S_20_00781,4144410,72450,1131519,2940441,NS.1272.003.D701.Qilalugene-P1_detailed.log,1203969,NS.1272.003
CTTCCA,S_20_00779,8480114,7567,2230965,6241582,NS.1272.003.D701.Qilalugene-P1_detailed.log,2238532,NS.1272.003
CGCGGT,S_20_00616,10076948,5959,2676254,7394735,NS.1272.003.D701.Qilalugene-P1_detailed.log,2682213,NS.1272.003
TATTTTT,S_20_00743,4704796,4848,1568694,3131254,NS.1272.003.D701.Qilalugene-P1_detailed.log,1573542,NS.1272.003
AACGCCT,S_20_03524,11651064,6449,3455644,8188971,NS.1272.003.D701.Qilalugene-P1_detailed.log,3462093,NS.1272.003
CTACGGA,S_20_00697,3042980,2609,919382,2120989,NS.1272.003.D701.Qilalugene-P1_detailed.log,921991,NS.1272.003
TAGGCCAT,S_20_00719,11726088,3375,3884679,7838034,NS.1272.003.D701.Qilalugene-P1_detailed.log,3888054,NS.1272.003
ACGTGGTA,S_20_00652,6211366,3706,2201811,4005849,NS.1272.003.D701.Qilalugene-P1_detailed.log,2205517,NS.1272.003
TTCCTGGA,S_20_03446,16771712,11292,5009639,11750781,NS.1272.003.D701.Qilalugene-P1_detailed.log,5020931,NS.1272.003
CTCG,S_20_00734,2504226,99023,843588,1561615,NS.1272.003.D702.Qilalugene-P2_detailed.log,942611,NS.1272.003
AGCG,S_20_01032,6361580,135121,2106206,4120253,NS.1272.003.D702.Qilalugene-P2_detailed.log,2241327,NS.1272.003
TTCTG,S_20_03511,497946,16795,174064,307087,NS.1272.003.D702.Qilalugene-P2_detailed.log,190859,NS.1272.003
ATTGA,S_20_00783,650554,28478,232699,389377,NS.1272.003.D702.Qilalugene-P2_detailed.log,261177,NS.1272.003
TCGTT,S_20_00766,7570072,15987,2478198,5075887,NS.1272.003.D702.Qilalugene-P2_detailed.log,2494185,NS.1272.003
GAGATA,S_20_00775,4766114,5127,1673744,3087243,NS.1272.003.D702.Qilalugene-P2_detailed.log,1678871,NS.1272.003
CTATTA,S_20_00731,3576424,8827,1395591,2172006,NS.1272.003.D702.Qilalugene-P2_detailed.log,1404418,NS.1272.003
CTTGCTT,S_20_03509,4636332,1331,1675270,2959731,NS.1272.003.D702.Qilalugene-P2_detailed.log,1676601,NS.1272.003
AATATGG,S_20_00753,9007488,15046,3506270,5486172,NS.1272.003.D702.Qilalugene-P2_detailed.log,3521316,NS.1272.003
GCGGAAT,S_20_03521,8882324,3640,2849099,6029585,NS.1272.003.D702.Qilalugene-P2_detailed.log,2852739,NS.1272.003
TGCAAGGA,S_20_03512,5941796,816,1965187,3975793,NS.1272.003.D702.Qilalugene-P2_detailed.log,1966003,NS.1272.003
CCATGGGT,S_20_00726,10196098,12834,3346428,6836836,NS.1272.003.D702.Qilalugene-P2_detailed.log,3359262,NS.1272.003
TGCA,S_20_00752,1944512,239738,772995,931779,NS.1272.003.D702.Qilalugene-P2_detailed.log,1012733,NS.1272.003
GATG,S_20_00690,2667990,113120,929792,1625078,NS.1272.003.D702.Qilalugene-P2_detailed.log,1042912,NS.1272.003
AGCCG,S_20_00809,7264964,23008,2444679,4797277,NS.1272.003.D702.Qilalugene-P2_detailed.log,2467687,NS.1272.003
CATCT,S_20_00608,7555074,38970,2681428,4834676,NS.1272.003.D702.Qilalugene-P2_detailed.log,2720398,NS.1272.003
GGTTGT,S_20_00602,9061234,6134,3277708,5777392,NS.1272.003.D702.Qilalugene-P2_detailed.log,3283842,NS.1272.003
ATGCCT,S_20_03516,5735306,4490,2246471,3484345,NS.1272.003.D702.Qilalugene-P2_detailed.log,2250961,NS.1272.003
GCCAGT,S_20_01213,11549736,10112,3600039,7939585,NS.1272.003.D702.Qilalugene-P2_detailed.log,3610151,NS.1272.003
ATGAAAG,S_20_00709,4702622,7147,1903539,2791936,NS.1272.003.D702.Qilalugene-P2_detailed.log,1910686,NS.1272.003
ACGTGTT,S_20_00713,2549168,7682,1022551,1518935,NS.1272.003.D702.Qilalugene-P2_detailed.log,1030233,NS.1272.003
TAGCGGA,S_20_00776,5435470,17225,1799849,3618396,NS.1272.003.D702.Qilalugene-P2_detailed.log,1817074,NS.1272.003
TGGTACGT,S_20_03505,1294246,507,644772,648967,NS.1272.003.D702.Qilalugene-P2_detailed.log,645279,NS.1272.003
CGCGGAGA,S_20_01222,4721400,1526,1449587,3270287,NS.1272.003.D702.Qilalugene-P2_detailed.log,1451113,NS.1272.003
ACTA,S_20_00614,2897892,174819,963545,1759528,NS.1272.003.D702.Qilalugene-P2_detailed.log,1138364,NS.1272.003
TCAG,S_20_00619,947528,69134,354599,523795,NS.1272.003.D702.Qilalugene-P2_detailed.log,423733,NS.1272.003
GTATT,S_20_03449,8276782,13904,2765092,5497786,NS.1272.003.D702.Qilalugene-P2_detailed.log,2778996,NS.1272.003
CCTAG,S_20_00772,8868576,14262,2931141,5923173,NS.1272.003.D702.Qilalugene-P2_detailed.log,2945403,NS.1272.003
CCACGT,S_20_00698,105100,30755,26480,47865,NS.1272.003.D702.Qilalugene-P2_detailed.log,57235,NS.1272.003
AGTGGA,S_20_00610,8272510,5203,2821192,5446115,NS.1272.003.D702.Qilalugene-P2_detailed.log,2826395,NS.1272.003
GGAAGA,S_20_03454,9710108,2285,3149917,6557906,NS.1272.003.D702.Qilalugene-P2_detailed.log,3152202,NS.1272.003
AAAAGTT,S_20_00694,776884,45822,259710,471352,NS.1272.003.D702.Qilalugene-P2_detailed.log,305532,NS.1272.003
ATTAATT,S_20_00722,4371608,5292,1630291,2736025,NS.1272.003.D702.Qilalugene-P2_detailed.log,1635583,NS.1272.003
TCGAAGA,S_20_00758,11934498,8099,4629974,7296425,NS.1272.003.D702.Qilalugene-P2_detailed.log,4638073,NS.1272.003
TCTCAGTG,S_20_00733,3859638,2444,1719134,2138060,NS.1272.003.D702.Qilalugene-P2_detailed.log,1721578,NS.1272.003
CGTGTGGT,S_20_00810,5194578,5837,1740628,3448113,NS.1272.003.D702.Qilalugene-P2_detailed.log,1746465,NS.1272.003
CAGA,S_20_01144,5568540,228486,1719913,3620141,NS.1272.003.D702.Qilalugene-P2_detailed.log,1948399,NS.1272.003
TGCGA,S_20_00799,6011148,2869,1881873,4126406,NS.1272.003.D702.Qilalugene-P2_detailed.log,1884742,NS.1272.003
CTGTA,S_20_00629,6489548,12867,2172257,4304424,NS.1272.003.D702.Qilalugene-P2_detailed.log,2185124,NS.1272.003
GAGGA,S_20_00702,1752520,65791,620420,1066309,NS.1272.003.D702.Qilalugene-P2_detailed.log,686211,NS.1272.003
TTCAGA,S_20_03451,13174546,5302,4286518,8882726,NS.1272.003.D702.Qilalugene-P2_detailed.log,4291820,NS.1272.003
ACCTAA,S_20_00740,9993262,10670,3262326,6720266,NS.1272.003.D702.Qilalugene-P2_detailed.log,3272996,NS.1272.003
GTACTT,S_20_01220,2296028,4911,653013,1638104,NS.1272.003.D702.Qilalugene-P2_detailed.log,657924,NS.1272.003
GAATTCA,S_20_00664,5073270,4328,1966922,3102020,NS.1272.003.D702.Qilalugene-P2_detailed.log,1971250,NS.1272.003
ATTGGAT,S_20_00691,1885768,4312,657276,1224180,NS.1272.003.D702.Qilalugene-P2_detailed.log,661588,NS.1272.003
TCTGTGA,S_20_00609,5246538,550,1773428,3472560,NS.1272.003.D702.Qilalugene-P2_detailed.log,1773978,NS.1272.003
CGCGATAT,S_20_00668,1694384,618,602360,1091406,NS.1272.003.D702.Qilalugene-P2_detailed.log,602978,NS.1272.003
GCTGTGGA,S_20_00627,3827756,589,1308556,2518611,NS.1272.003.D702.Qilalugene-P2_detailed.log,1309145,NS.1272.003
AACT,S_20_03447,4648064,260338,1380304,3007422,NS.1272.003.D702.Qilalugene-P2_detailed.log,1640642,NS.1272.003
CGCTT,S_20_00793,7454174,26609,2364388,5063177,NS.1272.003.D702.Qilalugene-P2_detailed.log,2390997,NS.1272.003
ACCGT,S_20_00785,213820,31763,67450,114607,NS.1272.003.D702.Qilalugene-P2_detailed.log,99213,NS.1272.003
GGAAG,S_20_00693,1538940,61714,542248,934978,NS.1272.003.D702.Qilalugene-P2_detailed.log,603962,NS.1272.003
TAGGAA,S_20_03507,12593500,14082,4468063,8111355,NS.1272.003.D702.Qilalugene-P2_detailed.log,4482145,NS.1272.003
ATATGT,S_20_03652,10028696,29591,3385680,6613425,NS.1272.003.D702.Qilalugene-P2_detailed.log,3415271,NS.1272.003
GTTGAA,S_20_00808,12773598,2355,4059289,8711954,NS.1272.003.D702.Qilalugene-P2_detailed.log,4061644,NS.1272.003
GAACTTG,S_20_00632,5202160,13843,1750478,3437839,NS.1272.003.D702.Qilalugene-P2_detailed.log,1764321,NS.1272.003
CATAAGT,S_20_03455,13888248,7644,4720551,9160053,NS.1272.003.D702.Qilalugene-P2_detailed.log,4728195,NS.1272.003
TGCTGGA,S_20_03450,16074664,1383,5154199,10919082,NS.1272.003.D702.Qilalugene-P2_detailed.log,5155582,NS.1272.003
CGCCTTAT,S_20_00695,8618376,3664,2988140,5626572,NS.1272.003.D702.Qilalugene-P2_detailed.log,2991804,NS.1272.003
GGATTGGT,S_20_00711,8204788,3933,3177469,5023386,NS.1272.003.D702.Qilalugene-P2_detailed.log,3181402,NS.1272.003
GCGT,S_20_00751,5856654,84519,1908407,3863728,NS.1272.003.D702.Qilalugene-P2_detailed.log,1992926,NS.1272.003
TCACG,S_20_00761,9968212,22244,3448284,6497684,NS.1272.003.D702.Qilalugene-P2_detailed.log,3470528,NS.1272.003
GCTTA,S_20_00904,7446858,13421,2782813,4650624,NS.1272.003.D702.Qilalugene-P2_detailed.log,2796234,NS.1272.003
GTCAA,S_20_00660,2720854,27609,948105,1745140,NS.1272.003.D702.Qilalugene-P2_detailed.log,975714,NS.1272.003
GCTCTA,S_20_00661,3809412,3230,1389686,2416496,NS.1272.003.D702.Qilalugene-P2_detailed.log,1392916,NS.1272.003
ATCGTA,S_20_00777,5173010,8392,1913541,3251077,NS.1272.003.D702.Qilalugene-P2_detailed.log,1921933,NS.1272.003
TAACGA,S_20_03453,9653944,32556,3501611,6119777,NS.1272.003.D702.Qilalugene-P2_detailed.log,3534167,NS.1272.003
GGACCTA,S_20_00669,1529518,915,574117,954486,NS.1272.003.D702.Qilalugene-P2_detailed.log,575032,NS.1272.003
CGCTGAT,S_20_00788,9720158,5194,3057115,6657849,NS.1272.003.D702.Qilalugene-P2_detailed.log,3062309,NS.1272.003
ACGACTAG,S_20_00750,6512150,4701,2494106,4013343,NS.1272.003.D702.Qilalugene-P2_detailed.log,2498807,NS.1272.003
AACCGAGA,S_20_00771,13827190,12700,4589908,9224582,NS.1272.003.D702.Qilalugene-P2_detailed.log,4602608,NS.1272.003
GTGAGGGT,S_20_00603,10441398,4671,3284537,7152190,NS.1272.003.D702.Qilalugene-P2_detailed.log,3289208,NS.1272.003
CGAT,S_20_00628,5460620,214949,1672608,3573063,NS.1272.003.D702.Qilalugene-P2_detailed.log,1887557,NS.1272.003
CTAGG,S_20_00796,12260028,37368,3927505,8295155,NS.1272.003.D702.Qilalugene-P2_detailed.log,3964873,NS.1272.003
GGTGT,S_20_00770,8097262,15243,2790835,5291184,NS.1272.003.D702.Qilalugene-P2_detailed.log,2806078,NS.1272.003
TAATA,S_20_01223,5376356,69388,1909430,3397538,NS.1272.003.D702.Qilalugene-P2_detailed.log,1978818,NS.1272.003
CCACAA,S_20_00812,9102140,20606,3088677,5992857,NS.1272.003.D702.Qilalugene-P2_detailed.log,3109283,NS.1272.003
CATCGT,S_20_00791,10544120,12240,3537527,6994353,NS.1272.003.D702.Qilalugene-P2_detailed.log,3549767,NS.1272.003
TGGCTA,S_20_00748,7148950,6167,2642688,4500095,NS.1272.003.D702.Qilalugene-P2_detailed.log,2648855,NS.1272.003
GTCGATT,S_20_00794,17045532,5391,5387771,11652370,NS.1272.003.D702.Qilalugene-P2_detailed.log,5393162,NS.1272.003
CGGTAGA,S_20_00611,6530434,1449,2274740,4254245,NS.1272.003.D702.Qilalugene-P2_detailed.log,2276189,NS.1272.003
TAGCATGG,S_20_01418,6669840,5296,2254985,4409559,NS.1272.003.D702.Qilalugene-P2_detailed.log,2260281,NS.1272.003
ACAGGGA,S_20_00763,408446,1538,152180,254728,NS.1272.003.D702.Qilalugene-P2_detailed.log,153718,NS.1272.003
TATCGGGA,S_20_00708,3278760,2653,934349,2341758,NS.1272.003.D702.Qilalugene-P2_detailed.log,937002,NS.1272.003
GTAA,S_20_00759,8380910,189346,3072093,5119471,NS.1272.003.D702.Qilalugene-P2_detailed.log,3261439,NS.1272.003
ACAAA,S_20_00813,13494330,191309,4696524,8606497,NS.1272.003.D702.Qilalugene-P2_detailed.log,4887833,NS.1272.003
AGGAT,S_20_00617,10858538,28765,3584043,7245730,NS.1272.003.D702.Qilalugene-P2_detailed.log,3612808,NS.1272.003
TACAT,S_20_00795,9172808,79546,3010308,6082954,NS.1272.003.D702.Qilalugene-P2_detailed.log,3089854,NS.1272.003
CTTCCA,S_20_00633,11851824,8654,3776620,8066550,NS.1272.003.D702.Qilalugene-P2_detailed.log,3785274,NS.1272.003
CGCGGT,S_20_00764,11938614,5937,4737229,7195448,NS.1272.003.D702.Qilalugene-P2_detailed.log,4743166,NS.1272.003
TATTTTT,S_20_00745,7405328,8031,2586242,4811055,NS.1272.003.D702.Qilalugene-P2_detailed.log,2594273,NS.1272.003
AACGCCT,S_20_00710,16177066,7042,5433107,10736917,NS.1272.003.D702.Qilalugene-P2_detailed.log,5440149,NS.1272.003
CTACGGA,S_20_00782,1833850,1651,690161,1142038,NS.1272.003.D702.Qilalugene-P2_detailed.log,691812,NS.1272.003
TAGGCCAT,S_20_03520,5268230,1490,1800659,3466081,NS.1272.003.D702.Qilalugene-P2_detailed.log,1802149,NS.1272.003
ACGTGGTA,S_20_01154,10724078,5245,3560807,7158026,NS.1272.003.D702.Qilalugene-P2_detailed.log,3566052,NS.1272.003
TTCCTGGA,S_20_00798,9318390,5346,2990893,6322151,NS.1272.003.D702.Qilalugene-P2_detailed.log,2996239,NS.1272.003
CTCG,S_20_01945,1756638,93581,326314,1336743,NS.1272.003.D703.Qilalugene-P3_detailed.log,419895,NS.1272.003
AGCG,S_20_01904,6173276,129897,1620325,4423054,NS.1272.003.D703.Qilalugene-P3_detailed.log,1750222,NS.1272.003
TTCTG,S_20_02582,4719224,9250,763764,3946210,NS.1272.003.D703.Qilalugene-P3_detailed.log,773014,NS.1272.003
ATTGA,S_20_00856_rep,2259268,45881,537185,1676202,NS.1272.003.D703.Qilalugene-P3_detailed.log,583066,NS.1272.003
TCGTT,S_20_00656,5091500,9638,919931,4161931,NS.1272.003.D703.Qilalugene-P3_detailed.log,929569,NS.1272.003
GAGATA,S_20_02963,8257090,5475,1478707,6772908,NS.1272.003.D703.Qilalugene-P3_detailed.log,1484182,NS.1272.003
CTATTA,S_20_01099,4019700,5933,1079895,2933872,NS.1272.003.D703.Qilalugene-P3_detailed.log,1085828,NS.1272.003
CTTGCTT,S_20_02103,22028000,5102,3901529,18121369,NS.1272.003.D703.Qilalugene-P3_detailed.log,3906631,NS.1272.003
AATATGG,S_20_03635,8727020,16909,1510163,7199948,NS.1272.003.D703.Qilalugene-P3_detailed.log,1527072,NS.1272.003
GCGGAAT,S_20_02356,5057778,2352,811581,4243845,NS.1272.003.D703.Qilalugene-P3_detailed.log,813933,NS.1272.003
TGCAAGGA,S_20_02388,4944762,810,819246,4124706,NS.1272.003.D703.Qilalugene-P3_detailed.log,820056,NS.1272.003
CCATGGGT,S_20_02352,8664134,9988,1667863,6986283,NS.1272.003.D703.Qilalugene-P3_detailed.log,1677851,NS.1272.003
TGCA,S_20_03419,3580162,65364,591782,2923016,NS.1272.003.D703.Qilalugene-P3_detailed.log,657146,NS.1272.003
GATG,S_20_01893,19504244,104060,2480930,16919254,NS.1272.003.D703.Qilalugene-P3_detailed.log,2584990,NS.1272.003
AGCCG,S_20_01019,6461258,12212,904541,5544505,NS.1272.003.D703.Qilalugene-P3_detailed.log,916753,NS.1272.003
CATCT,S_20_03586,15456770,35583,2699306,12721881,NS.1272.003.D703.Qilalugene-P3_detailed.log,2734889,NS.1272.003
GGTTGT,S_20_00836,5792990,3075,884314,4905601,NS.1272.003.D703.Qilalugene-P3_detailed.log,887389,NS.1272.003
ATGCCT,S_20_00916,8830558,5862,1593833,7230863,NS.1272.003.D703.Qilalugene-P3_detailed.log,1599695,NS.1272.003
GCCAGT,S_20_00925,3989180,6961,796560,3185659,NS.1272.003.D703.Qilalugene-P3_detailed.log,803521,NS.1272.003
ATGAAAG,S_20_00905,10859932,12031,2015686,8832215,NS.1272.003.D703.Qilalugene-P3_detailed.log,2027717,NS.1272.003
ACGTGTT,S_20_00942,4828638,5364,877285,3945989,NS.1272.003.D703.Qilalugene-P3_detailed.log,882649,NS.1272.003
TAGCGGA,S_20_03000,5519708,7343,961326,4551039,NS.1272.003.D703.Qilalugene-P3_detailed.log,968669,NS.1272.003
TGGTACGT,S_20_01018,1754892,390,341828,1412674,NS.1272.003.D703.Qilalugene-P3_detailed.log,342218,NS.1272.003
CGCGGAGA,S_20_03656,7985342,1217,1786339,6197786,NS.1272.003.D703.Qilalugene-P3_detailed.log,1787556,NS.1272.003
ACTA,S_20_02178,3807006,163183,621405,3022418,NS.1272.003.D703.Qilalugene-P3_detailed.log,784588,NS.1272.003
TCAG,S_20_03583,7228552,55493,1277712,5895347,NS.1272.003.D703.Qilalugene-P3_detailed.log,1333205,NS.1272.003
GTATT,S_20_02392,6717998,12212,1166087,5539699,NS.1272.003.D703.Qilalugene-P3_detailed.log,1178299,NS.1272.003
CCTAG,S_20_01883,18477478,11315,2854847,15611316,NS.1272.003.D703.Qilalugene-P3_detailed.log,2866162,NS.1272.003
CCACGT,S_20_01022,2806612,46179,687025,2073408,NS.1272.003.D703.Qilalugene-P3_detailed.log,733204,NS.1272.003
AGTGGA,S_20_00978,3490600,15257,927127,2548216,NS.1272.003.D703.Qilalugene-P3_detailed.log,942384,NS.1272.003
GGAAGA,S_20_01126,2131982,6145,417454,1708383,NS.1272.003.D703.Qilalugene-P3_detailed.log,423599,NS.1272.003
AAAAGTT,S_20_01077,2811570,33202,658556,2119812,NS.1272.003.D703.Qilalugene-P3_detailed.log,691758,NS.1272.003
ATTAATT,S_20_03029,7480104,5720,1633230,5841154,NS.1272.003.D703.Qilalugene-P3_detailed.log,1638950,NS.1272.003
TCGAAGA,S_20_01940,5659496,4087,1127593,4527816,NS.1272.003.D703.Qilalugene-P3_detailed.log,1131680,NS.1272.003
TCTCAGTG,S_20_02728,4547034,3175,966305,3577554,NS.1272.003.D703.Qilalugene-P3_detailed.log,969480,NS.1272.003
CGTGTGGT,S_20_00856,3453350,3964,817186,2632200,NS.1272.003.D703.Qilalugene-P3_detailed.log,821150,NS.1272.003
CAGA,S_20_01013,1261168,158988,282876,819304,NS.1272.003.D703.Qilalugene-P3_detailed.log,441864,NS.1272.003
TGCGA,S_20_03085,12240432,3791,1975045,10261596,NS.1272.003.D703.Qilalugene-P3_detailed.log,1978836,NS.1272.003
CTGTA,S_20_00996,1967260,9577,582025,1375658,NS.1272.003.D703.Qilalugene-P3_detailed.log,591602,NS.1272.003
GAGGA,S_20_01944,14613962,55331,2556549,12002082,NS.1272.003.D703.Qilalugene-P3_detailed.log,2611880,NS.1272.003
TTCAGA,S_20_01147,1784480,1203,356777,1426500,NS.1272.003.D703.Qilalugene-P3_detailed.log,357980,NS.1272.003
ACCTAA,S_20_03588,10894396,6751,1894622,8993023,NS.1272.003.D703.Qilalugene-P3_detailed.log,1901373,NS.1272.003
GTACTT,S_20_03090,5058216,5014,1086412,3966790,NS.1272.003.D703.Qilalugene-P3_detailed.log,1091426,NS.1272.003
GAATTCA,S_20_03038,2532110,2783,727550,1801777,NS.1272.003.D703.Qilalugene-P3_detailed.log,730333,NS.1272.003
ATTGGAT,S_20_01005,6354940,3667,1055520,5295753,NS.1272.003.D703.Qilalugene-P3_detailed.log,1059187,NS.1272.003
TCTGTGA,S_20_02108,6466964,668,1070545,5395751,NS.1272.003.D703.Qilalugene-P3_detailed.log,1071213,NS.1272.003
CGCGATAT,S_20_02257,2127734,738,307282,1819714,NS.1272.003.D703.Qilalugene-P3_detailed.log,308020,NS.1272.003
GCTGTGGA,S_20_02767,5764484,733,1231427,4532324,NS.1272.003.D703.Qilalugene-P3_detailed.log,1232160,NS.1272.003
AACT,S_20_02726,3987276,167607,718748,3100921,NS.1272.003.D703.Qilalugene-P3_detailed.log,886355,NS.1272.003
CGCTT,S_20_00995,2664932,10134,779825,1874973,NS.1272.003.D703.Qilalugene-P3_detailed.log,789959,NS.1272.003
ACCGT,S_20_01084,2450402,27812,496515,1926075,NS.1272.003.D703.Qilalugene-P3_detailed.log,524327,NS.1272.003
GGAAG,S_20_00828,13162892,36889,2382624,10743379,NS.1272.003.D703.Qilalugene-P3_detailed.log,2419513,NS.1272.003
TAGGAA,S_20_00918,2361450,7721,384276,1969453,NS.1272.003.D703.Qilalugene-P3_detailed.log,391997,NS.1272.003
ATATGT,S_20_02354,8022212,22549,1352043,6647620,NS.1272.003.D703.Qilalugene-P3_detailed.log,1374592,NS.1272.003
GTTGAA,S_20_00861,2582302,599,403980,2177723,NS.1272.003.D703.Qilalugene-P3_detailed.log,404579,NS.1272.003
GAACTTG,S_20_03087,6452754,17091,977041,5458622,NS.1272.003.D703.Qilalugene-P3_detailed.log,994132,NS.1272.003
CATAAGT,S_20_01894,4557652,2815,872517,3682320,NS.1272.003.D703.Qilalugene-P3_detailed.log,875332,NS.1272.003
TGCTGGA,S_20_03624,4586702,408,856716,3729578,NS.1272.003.D703.Qilalugene-P3_detailed.log,857124,NS.1272.003
CGCCTTAT,S_20_00985,1406398,637,428304,977457,NS.1272.003.D703.Qilalugene-P3_detailed.log,428941,NS.1272.003
GGATTGGT,S_20_01004,2826180,937,908971,1916272,NS.1272.003.D703.Qilalugene-P3_detailed.log,909908,NS.1272.003
GCGT,S_20_00998,840274,67154,288019,485101,NS.1272.003.D703.Qilalugene-P3_detailed.log,355173,NS.1272.003
TCACG,S_20_02385,7683528,18987,1273206,6391335,NS.1272.003.D703.Qilalugene-P3_detailed.log,1292193,NS.1272.003
GCTTA,S_20_03056,1932106,5782,530954,1395370,NS.1272.003.D703.Qilalugene-P3_detailed.log,536736,NS.1272.003
GTCAA,S_20_02910,10671380,16510,2026599,8628271,NS.1272.003.D703.Qilalugene-P3_detailed.log,2043109,NS.1272.003
GCTCTA,S_20_01011,935576,1359,387002,547215,NS.1272.003.D703.Qilalugene-P3_detailed.log,388361,NS.1272.003
ATCGTA,S_20_00964,3267380,5288,891513,2370579,NS.1272.003.D703.Qilalugene-P3_detailed.log,896801,NS.1272.003
TAACGA,S_20_01023,2264586,22231,453416,1788939,NS.1272.003.D703.Qilalugene-P3_detailed.log,475647,NS.1272.003
GGACCTA,S_20_03625,2034338,1218,324846,1708274,NS.1272.003.D703.Qilalugene-P3_detailed.log,326064,NS.1272.003
CGCTGAT,S_20_01050,6851506,2604,1254675,5594227,NS.1272.003.D703.Qilalugene-P3_detailed.log,1257279,NS.1272.003
ACGACTAG,S_20_02382,5476256,4024,1075892,4396340,NS.1272.003.D703.Qilalugene-P3_detailed.log,1079916,NS.1272.003
AACCGAGA,S_20_00920,3911790,3953,829784,3078053,NS.1272.003.D703.Qilalugene-P3_detailed.log,833737,NS.1272.003
GTGAGGGT,S_20_01092,3300172,1719,710391,2588062,NS.1272.003.D703.Qilalugene-P3_detailed.log,712110,NS.1272.003
CGAT,S_20_00850,1606834,131770,373286,1101778,NS.1272.003.D703.Qilalugene-P3_detailed.log,505056,NS.1272.003
CTAGG,S_20_03086,6307746,49262,1120465,5138019,NS.1272.003.D703.Qilalugene-P3_detailed.log,1169727,NS.1272.003
GGTGT,S_20_00646,3441500,30514,837793,2573193,NS.1272.003.D703.Qilalugene-P3_detailed.log,868307,NS.1272.003
TAATA,S_20_03344,11256770,47971,2249731,8959068,NS.1272.003.D703.Qilalugene-P3_detailed.log,2297702,NS.1272.003
CCACAA,S_20_03630,5329536,11612,863832,4454092,NS.1272.003.D703.Qilalugene-P3_detailed.log,875444,NS.1272.003
CATCGT,S_20_01097,8635638,21613,1463774,7150251,NS.1272.003.D703.Qilalugene-P3_detailed.log,1485387,NS.1272.003
TGGCTA,S_20_00983,3449916,4002,763886,2682028,NS.1272.003.D703.Qilalugene-P3_detailed.log,767888,NS.1272.003
GTCGATT,S_20_03210,4992652,2248,929637,4060767,NS.1272.003.D703.Qilalugene-P3_detailed.log,931885,NS.1272.003
CGGTAGA,S_20_03099,2896642,472,600290,2295880,NS.1272.003.D703.Qilalugene-P3_detailed.log,600762,NS.1272.003
TAGCATGG,S_20_01793,6298104,6156,1490032,4801916,NS.1272.003.D703.Qilalugene-P3_detailed.log,1496188,NS.1272.003
ACAGGGA,S_20_01025,2702524,3394,557520,2141610,NS.1272.003.D703.Qilalugene-P3_detailed.log,560914,NS.1272.003
TATCGGGA,S_20_00862,6226024,5538,1370769,4849717,NS.1272.003.D703.Qilalugene-P3_detailed.log,1376307,NS.1272.003
GTAA,S_20_03486,3864004,105338,671258,3087408,NS.1272.003.D703.Qilalugene-P3_detailed.log,776596,NS.1272.003
ACAAA,S_20_03665,3849432,138002,843001,2868429,NS.1272.003.D703.Qilalugene-P3_detailed.log,981003,NS.1272.003
AGGAT,S_20_03083,4854030,23143,941242,3889645,NS.1272.003.D703.Qilalugene-P3_detailed.log,964385,NS.1272.003
TACAT,S_20_00832,6286020,37966,1247710,5000344,NS.1272.003.D703.Qilalugene-P3_detailed.log,1285676,NS.1272.003
CTTCCA,S_20_01052,3066332,4566,554544,2507222,NS.1272.003.D703.Qilalugene-P3_detailed.log,559110,NS.1272.003
CGCGGT,S_20_02608,6546478,3685,1121417,5421376,NS.1272.003.D703.Qilalugene-P3_detailed.log,1125102,NS.1272.003
TATTTTT,S_20_01013_rep,3762946,4072,828769,2930105,NS.1272.003.D703.Qilalugene-P3_detailed.log,832841,NS.1272.003
AACGCCT,S_20_03212,3646070,1740,596992,3047338,NS.1272.003.D703.Qilalugene-P3_detailed.log,598732,NS.1272.003
CTACGGA,S_20_01075,6575524,5217,1342875,5227432,NS.1272.003.D703.Qilalugene-P3_detailed.log,1348092,NS.1272.003
TAGGCCAT,S_20_00651,4380604,1363,903641,3475600,NS.1272.003.D703.Qilalugene-P3_detailed.log,905004,NS.1272.003
ACGTGGTA,S_20_01938,2887080,2908,434572,2449600,NS.1272.003.D703.Qilalugene-P3_detailed.log,437480,NS.1272.003
TTCCTGGA,S_20_00988,2802056,1923,918715,1881418,NS.1272.003.D703.Qilalugene-P3_detailed.log,920638,NS.1272.003
CTCG,S_20_01873,3622084,50235,173161,3398688,NS.1272.003.D704.Qilalugene-P4_detailed.log,223396,NS.1272.003
AGCG,S_20_03605,2179650,110640,148448,1920562,NS.1272.003.D704.Qilalugene-P4_detailed.log,259088,NS.1272.003
TTCTG,S_20_00640,3333586,7802,417538,2908246,NS.1272.003.D704.Qilalugene-P4_detailed.log,425340,NS.1272.003
ATTGA,S_20_01896,11881166,41887,698474,11140805,NS.1272.003.D704.Qilalugene-P4_detailed.log,740361,NS.1272.003
TCGTT,S_20_03527,16226462,14903,967125,15244434,NS.1272.003.D704.Qilalugene-P4_detailed.log,982028,NS.1272.003
GAGATA,S_20_01027,1295988,4124,221399,1070465,NS.1272.003.D704.Qilalugene-P4_detailed.log,225523,NS.1272.003
CTATTA,S_20_01629,11382698,8446,979988,10394264,NS.1272.003.D704.Qilalugene-P4_detailed.log,988434,NS.1272.003
CTTGCTT,S_20_01076,4710794,1285,322578,4386931,NS.1272.003.D704.Qilalugene-P4_detailed.log,323863,NS.1272.003
AATATGG,S_20_01046,1729440,7628,121588,1600224,NS.1272.003.D704.Qilalugene-P4_detailed.log,129216,NS.1272.003
GCGGAAT,S_20_01070,537050,1205,95885,439960,NS.1272.003.D704.Qilalugene-P4_detailed.log,97090,NS.1272.003
TGCAAGGA,S_20_01906,8756082,1536,509735,8244811,NS.1272.003.D704.Qilalugene-P4_detailed.log,511271,NS.1272.003
CCATGGGT,S_20_00915,1727004,2091,182829,1542084,NS.1272.003.D704.Qilalugene-P4_detailed.log,184920,NS.1272.003
TGCA,S_20_01947,4144940,104598,361675,3678667,NS.1272.003.D704.Qilalugene-P4_detailed.log,466273,NS.1272.003
GATG,S_20_02611,7218424,97013,483901,6637510,NS.1272.003.D704.Qilalugene-P4_detailed.log,580914,NS.1272.003
AGCCG,S_20_02182,8104062,15081,460243,7628738,NS.1272.003.D704.Qilalugene-P4_detailed.log,475324,NS.1272.003
CATCT,S_20_02258,8330792,26845,559226,7744721,NS.1272.003.D704.Qilalugene-P4_detailed.log,586071,NS.1272.003
GGTTGT,S_20_01791,12945282,6659,584359,12354264,NS.1272.003.D704.Qilalugene-P4_detailed.log,591018,NS.1272.003
ATGCCT,S_20_00952,10169150,5957,652543,9510650,NS.1272.003.D704.Qilalugene-P4_detailed.log,658500,NS.1272.003
GCCAGT,S_20_00999,1838648,3538,337279,1497831,NS.1272.003.D704.Qilalugene-P4_detailed.log,340817,NS.1272.003
ATGAAAG,S_20_03608,29113972,32190,1872662,27209120,NS.1272.003.D704.Qilalugene-P4_detailed.log,1904852,NS.1272.003
ACGTGTT,S_20_02374,4167158,4390,258295,3904473,NS.1272.003.D704.Qilalugene-P4_detailed.log,262685,NS.1272.003
TAGCGGA,S_20_02908,3494064,4860,218982,3270222,NS.1272.003.D704.Qilalugene-P4_detailed.log,223842,NS.1272.003
TGGTACGT,S_20_00987,2164274,758,236481,1927035,NS.1272.003.D704.Qilalugene-P4_detailed.log,237239,NS.1272.003
CGCGGAGA,S_20_02635,3019916,677,211207,2808032,NS.1272.003.D704.Qilalugene-P4_detailed.log,211884,NS.1272.003
ACTA,S_20_00829,4089228,143781,275697,3669750,NS.1272.003.D704.Qilalugene-P4_detailed.log,419478,NS.1272.003
TCAG,S_20_03187,1496254,48400,215506,1232348,NS.1272.003.D704.Qilalugene-P4_detailed.log,263906,NS.1272.003
GTATT,S_20_00676,2374630,24772,321065,2028793,NS.1272.003.D704.Qilalugene-P4_detailed.log,345837,NS.1272.003
CCTAG,S_20_00912,9629728,6941,462992,9159795,NS.1272.003.D704.Qilalugene-P4_detailed.log,469933,NS.1272.003
CCACGT,S_20_03343,7275662,25501,454718,6795443,NS.1272.003.D704.Qilalugene-P4_detailed.log,480219,NS.1272.003
AGTGGA,S_20_01942,8104618,11833,421119,7671666,NS.1272.003.D704.Qilalugene-P4_detailed.log,432952,NS.1272.003
GGAAGA,S_20_02353,10307480,2786,566659,9738035,NS.1272.003.D704.Qilalugene-P4_detailed.log,569445,NS.1272.003
AAAAGTT,S_20_03088,11379680,32584,809857,10537239,NS.1272.003.D704.Qilalugene-P4_detailed.log,842441,NS.1272.003
ATTAATT,S_20_01797,4830632,5539,391340,4433753,NS.1272.003.D704.Qilalugene-P4_detailed.log,396879,NS.1272.003
TCGAAGA,S_20_03340,2695606,2674,162458,2530474,NS.1272.003.D704.Qilalugene-P4_detailed.log,165132,NS.1272.003
TCTCAGTG,S_20_03577,3161076,2426,232301,2926349,NS.1272.003.D704.Qilalugene-P4_detailed.log,234727,NS.1272.003
CGTGTGGT,S_20_01007,812484,1250,106698,704536,NS.1272.003.D704.Qilalugene-P4_detailed.log,107948,NS.1272.003
CAGA,S_20_01113,2633344,114924,189328,2329092,NS.1272.003.D704.Qilalugene-P4_detailed.log,304252,NS.1272.003
TGCGA,S_20_00917,8214106,4103,406139,7803864,NS.1272.003.D704.Qilalugene-P4_detailed.log,410242,NS.1272.003
CTGTA,S_20_00992,1747584,7340,213558,1526686,NS.1272.003.D704.Qilalugene-P4_detailed.log,220898,NS.1272.003
GAGGA,S_20_01706,6190818,35057,342801,5812960,NS.1272.003.D704.Qilalugene-P4_detailed.log,377858,NS.1272.003
TTCAGA,S_20_01986,8507472,2985,480125,8024362,NS.1272.003.D704.Qilalugene-P4_detailed.log,483110,NS.1272.003
ACCTAA,S_20_03582,8206558,5674,499003,7701881,NS.1272.003.D704.Qilalugene-P4_detailed.log,504677,NS.1272.003
GTACTT,S_20_00833,10019602,14733,729235,9275634,NS.1272.003.D704.Qilalugene-P4_detailed.log,743968,NS.1272.003
GAATTCA,S_20_02350,12160306,8029,753968,11398309,NS.1272.003.D704.Qilalugene-P4_detailed.log,761997,NS.1272.003
ATTGGAT,S_20_01040,3946400,6116,239224,3701060,NS.1272.003.D704.Qilalugene-P4_detailed.log,245340,NS.1272.003
TCTGTGA,S_20_01078,2806758,389,168213,2638156,NS.1272.003.D704.Qilalugene-P4_detailed.log,168602,NS.1272.003
CGCGATAT,S_20_01900,2419498,801,199529,2219168,NS.1272.003.D704.Qilalugene-P4_detailed.log,200330,NS.1272.003
GCTGTGGA,S_20_00943,2576090,431,161149,2414510,NS.1272.003.D704.Qilalugene-P4_detailed.log,161580,NS.1272.003
AACT,S_20_00866,4663288,161505,316026,4185757,NS.1272.003.D704.Qilalugene-P4_detailed.log,477531,NS.1272.003
CGCTT,S_20_00655,365442,11130,80987,273325,NS.1272.003.D704.Qilalugene-P4_detailed.log,92117,NS.1272.003
ACCGT,S_20_02115,2300326,23467,178922,2097937,NS.1272.003.D704.Qilalugene-P4_detailed.log,202389,NS.1272.003
GGAAG,S_20_00835,1589692,66032,237963,1285697,NS.1272.003.D704.Qilalugene-P4_detailed.log,303995,NS.1272.003
TAGGAA,S_20_02179,6992530,6543,388470,6597517,NS.1272.003.D704.Qilalugene-P4_detailed.log,395013,NS.1272.003
ATATGT,S_20_01630,5305136,12177,426880,4866079,NS.1272.003.D704.Qilalugene-P4_detailed.log,439057,NS.1272.003
GTTGAA,S_20_03035,7908438,1834,612648,7293956,NS.1272.003.D704.Qilalugene-P4_detailed.log,614482,NS.1272.003
GAACTTG,S_20_00899,9783564,21822,976027,8785715,NS.1272.003.D704.Qilalugene-P4_detailed.log,997849,NS.1272.003
CATAAGT,S_20_03092,2725228,2213,175158,2547857,NS.1272.003.D704.Qilalugene-P4_detailed.log,177371,NS.1272.003
TGCTGGA,S_20_03525,3111466,409,172724,2938333,NS.1272.003.D704.Qilalugene-P4_detailed.log,173133,NS.1272.003
CGCCTTAT,S_20_02912,2587042,1348,189323,2396371,NS.1272.003.D704.Qilalugene-P4_detailed.log,190671,NS.1272.003
GGATTGGT,S_20_03599,4102296,2928,233031,3866337,NS.1272.003.D704.Qilalugene-P4_detailed.log,235959,NS.1272.003
GCGT,S_20_02102,3861422,111792,231641,3517989,NS.1272.003.D704.Qilalugene-P4_detailed.log,343433,NS.1272.003
TCACG,S_20_01098,2717904,14690,209988,2493226,NS.1272.003.D704.Qilalugene-P4_detailed.log,224678,NS.1272.003
GCTTA,S_20_03572,4765800,8830,298394,4458576,NS.1272.003.D704.Qilalugene-P4_detailed.log,307224,NS.1272.003
GTCAA,S_20_02104,6223452,19485,359350,5844617,NS.1272.003.D704.Qilalugene-P4_detailed.log,378835,NS.1272.003
GCTCTA,S_20_03218,3619692,2559,286463,3330670,NS.1272.003.D704.Qilalugene-P4_detailed.log,289022,NS.1272.003
ATCGTA,S_20_03095,4670824,5198,233630,4431996,NS.1272.003.D704.Qilalugene-P4_detailed.log,238828,NS.1272.003
TAACGA,S_20_01002,3412092,17294,441331,2953467,NS.1272.003.D704.Qilalugene-P4_detailed.log,458625,NS.1272.003
GGACCTA,S_20_02177,5401928,3778,426785,4971365,NS.1272.003.D704.Qilalugene-P4_detailed.log,430563,NS.1272.003
CGCTGAT,S_20_02911,2409384,1809,196669,2210906,NS.1272.003.D704.Qilalugene-P4_detailed.log,198478,NS.1272.003
ACGACTAG,S_20_00896,818052,921,124650,692481,NS.1272.003.D704.Qilalugene-P4_detailed.log,125571,NS.1272.003
AACCGAGA,S_20_01099_rep,3120828,3761,256962,2860105,NS.1272.003.D704.Qilalugene-P4_detailed.log,260723,NS.1272.003
GTGAGGGT,S_20_01210,2730846,3149,156382,2571315,NS.1272.003.D704.Qilalugene-P4_detailed.log,159531,NS.1272.003
CGAT,S_20_01107,998428,134108,115026,749294,NS.1272.003.D704.Qilalugene-P4_detailed.log,249134,NS.1272.003
CTAGG,S_20_03477,444286,23400,139269,281617,NS.1272.003.D704.Qilalugene-P4_detailed.log,162669,NS.1272.003
GGTGT,S_20_01006,2270730,18438,251975,2000317,NS.1272.003.D704.Qilalugene-P4_detailed.log,270413,NS.1272.003
TAATA,S_20_00955,3572332,47494,371502,3153336,NS.1272.003.D704.Qilalugene-P4_detailed.log,418996,NS.1272.003
CCACAA,S_20_03118,5751376,11516,306618,5433242,NS.1272.003.D704.Qilalugene-P4_detailed.log,318134,NS.1272.003
CATCGT,S_20_00967,2013262,11769,253098,1748395,NS.1272.003.D704.Qilalugene-P4_detailed.log,264867,NS.1272.003
TGGCTA,S_20_02100,8030206,6168,673730,7350308,NS.1272.003.D704.Qilalugene-P4_detailed.log,679898,NS.1272.003
GTCGATT,S_20_00997,1448296,609,413433,1034254,NS.1272.003.D704.Qilalugene-P4_detailed.log,414042,NS.1272.003
CGGTAGA,S_20_03595,3185274,589,170570,3014115,NS.1272.003.D704.Qilalugene-P4_detailed.log,171159,NS.1272.003
TAGCATGG,S_20_03096,3140644,3964,200200,2936480,NS.1272.003.D704.Qilalugene-P4_detailed.log,204164,NS.1272.003
ACAGGGA,S_20_01088,3223102,4379,184376,3034347,NS.1272.003.D704.Qilalugene-P4_detailed.log,188755,NS.1272.003
TATCGGGA,S_20_01707,3006594,3226,249394,2753974,NS.1272.003.D704.Qilalugene-P4_detailed.log,252620,NS.1272.003
GTAA,S_20_00682,1512972,138627,172280,1202065,NS.1272.003.D704.Qilalugene-P4_detailed.log,310907,NS.1272.003
ACAAA,S_20_00976,2356100,142436,198242,2015422,NS.1272.003.D704.Qilalugene-P4_detailed.log,340678,NS.1272.003
AGGAT,S_20_00638,1674190,34235,190942,1449013,NS.1272.003.D704.Qilalugene-P4_detailed.log,225177,NS.1272.003
TACAT,S_20_03633,7094006,50342,423588,6620076,NS.1272.003.D704.Qilalugene-P4_detailed.log,473930,NS.1272.003
CTTCCA,S_20_00649,5253010,4711,342216,4906083,NS.1272.003.D704.Qilalugene-P4_detailed.log,346927,NS.1272.003
CGCGGT,S_20_00957,2263212,1750,240422,2021040,NS.1272.003.D704.Qilalugene-P4_detailed.log,242172,NS.1272.003
TATTTTT,S_20_02255,7049944,8293,525060,6516591,NS.1272.003.D704.Qilalugene-P4_detailed.log,533353,NS.1272.003
AACGCCT,S_20_01102,4121022,2081,584909,3534032,NS.1272.003.D704.Qilalugene-P4_detailed.log,586990,NS.1272.003
CTACGGA,S_20_01071,4078900,3647,302410,3772843,NS.1272.003.D704.Qilalugene-P4_detailed.log,306057,NS.1272.003
TAGGCCAT,S_20_00704,1305958,558,137372,1168028,NS.1272.003.D704.Qilalugene-P4_detailed.log,137930,NS.1272.003
ACGTGGTA,S_20_00648,942748,2009,130865,809874,NS.1272.003.D704.Qilalugene-P4_detailed.log,132874,NS.1272.003
TTCCTGGA,S_20_00993,1888242,1633,232032,1654577,NS.1272.003.D704.Qilalugene-P4_detailed.log,233665,NS.1272.003
CTCG,S_20_03183,4230596,59374,567334,3603888,NS.1272.003.D705.Qilalugene-P5_detailed.log,626708,NS.1272.003
AGCG,S_20_00884,4756730,153409,507225,4096096,NS.1272.003.D705.Qilalugene-P5_detailed.log,660634,NS.1272.003
TTCTG,S_20_00639,5453120,14378,721759,4716983,NS.1272.003.D705.Qilalugene-P5_detailed.log,736137,NS.1272.003
ATTGA,S_20_03634,7719994,35810,613082,7071102,NS.1272.003.D705.Qilalugene-P5_detailed.log,648892,NS.1272.003
TCGTT,S_20_01863,15465878,17061,1307269,14141548,NS.1272.003.D705.Qilalugene-P5_detailed.log,1324330,NS.1272.003
GAGATA,S_20_01100,866732,4172,206440,656120,NS.1272.003.D705.Qilalugene-P5_detailed.log,210612,NS.1272.003
CTATTA,S_20_00994,1405800,7302,265318,1133180,NS.1272.003.D705.Qilalugene-P5_detailed.log,272620,NS.1272.003
CTTGCTT,S_20_00820,2829122,1339,330115,2497668,NS.1272.003.D705.Qilalugene-P5_detailed.log,331454,NS.1272.003
AATATGG,S_20_02174,11031516,23673,830675,10177168,NS.1272.003.D705.Qilalugene-P5_detailed.log,854348,NS.1272.003
GCGGAAT,S_20_03001,6136934,5079,452107,5679748,NS.1272.003.D705.Qilalugene-P5_detailed.log,457186,NS.1272.003
TGCAAGGA,S_20_01878,17776382,3030,1154381,16618971,NS.1272.003.D705.Qilalugene-P5_detailed.log,1157411,NS.1272.003
CCATGGGT,S_20_02539,2878108,4213,346470,2527425,NS.1272.003.D705.Qilalugene-P5_detailed.log,350683,NS.1272.003
TGCA,S_20_03636,19851506,149264,1408801,18293441,NS.1272.003.D705.Qilalugene-P5_detailed.log,1558065,NS.1272.003
GATG,S_20_02540,4107590,86670,628196,3392724,NS.1272.003.D705.Qilalugene-P5_detailed.log,714866,NS.1272.003
AGCCG,S_20_00645,3765374,13214,521456,3230704,NS.1272.003.D705.Qilalugene-P5_detailed.log,534670,NS.1272.003
CATCT,S_20_02364,7191968,32498,559549,6599921,NS.1272.003.D705.Qilalugene-P5_detailed.log,592047,NS.1272.003
GGTTGT,S_20_02537,6196146,3273,881987,5310886,NS.1272.003.D705.Qilalugene-P5_detailed.log,885260,NS.1272.003
ATGCCT,S_20_01009,6943244,5557,901143,6036544,NS.1272.003.D705.Qilalugene-P5_detailed.log,906700,NS.1272.003
GCCAGT,S_20_01008,1608862,5958,193952,1408952,NS.1272.003.D705.Qilalugene-P5_detailed.log,199910,NS.1272.003
ATGAAAG,S_20_01636,2027206,5484,218721,1803001,NS.1272.003.D705.Qilalugene-P5_detailed.log,224205,NS.1272.003
ACGTGTT,S_20_00926,5813828,5639,520059,5288130,NS.1272.003.D705.Qilalugene-P5_detailed.log,525698,NS.1272.003
TAGCGGA,S_20_00945,3000800,3958,455580,2541262,NS.1272.003.D705.Qilalugene-P5_detailed.log,459538,NS.1272.003
TGGTACGT,S_20_00966,1528748,450,208610,1319688,NS.1272.003.D705.Qilalugene-P5_detailed.log,209060,NS.1272.003
CGCGGAGA,S_20_00831,2142376,540,320080,1821756,NS.1272.003.D705.Qilalugene-P5_detailed.log,320620,NS.1272.003
ACTA,S_20_02444,8338988,246385,820034,7272569,NS.1272.003.D705.Qilalugene-P5_detailed.log,1066419,NS.1272.003
TCAG,S_20_00705,1551644,61912,245440,1244292,NS.1272.003.D705.Qilalugene-P5_detailed.log,307352,NS.1272.003
GTATT,S_20_00913,7773628,10215,522867,7240546,NS.1272.003.D705.Qilalugene-P5_detailed.log,533082,NS.1272.003
CCTAG,S_20_02362,4943360,7722,412752,4522886,NS.1272.003.D705.Qilalugene-P5_detailed.log,420474,NS.1272.003
CCACGT,S_20_03341,10928700,27471,793758,10107471,NS.1272.003.D705.Qilalugene-P5_detailed.log,821229,NS.1272.003
AGTGGA,S_20_03342,11718614,11976,889470,10817168,NS.1272.003.D705.Qilalugene-P5_detailed.log,901446,NS.1272.003
GGAAGA,S_20_02384,1345112,3085,86415,1255612,NS.1272.003.D705.Qilalugene-P5_detailed.log,89500,NS.1272.003
AAAAGTT,S_20_00634,565454,28401,80063,456990,NS.1272.003.D705.Qilalugene-P5_detailed.log,108464,NS.1272.003
ATTAATT,S_20_03054,14011004,15036,1038515,12957453,NS.1272.003.D705.Qilalugene-P5_detailed.log,1053551,NS.1272.003
TCGAAGA,S_20_01124,8716908,8623,685604,8022681,NS.1272.003.D705.Qilalugene-P5_detailed.log,694227,NS.1272.003
TCTCAGTG,S_20_02355,12189752,9272,953986,11226494,NS.1272.003.D705.Qilalugene-P5_detailed.log,963258,NS.1272.003
CGTGTGGT,S_20_03600,5569144,8243,364770,5196131,NS.1272.003.D705.Qilalugene-P5_detailed.log,373013,NS.1272.003
CAGA,S_20_01773,2240332,150363,490270,1599699,NS.1272.003.D705.Qilalugene-P5_detailed.log,640633,NS.1272.003
TGCGA,S_20_02381,6804036,6561,549313,6248162,NS.1272.003.D705.Qilalugene-P5_detailed.log,555874,NS.1272.003
CTGTA,S_20_01920,7845052,14427,608869,7221756,NS.1272.003.D705.Qilalugene-P5_detailed.log,623296,NS.1272.003
GAGGA,S_20_01637,4116170,68300,378048,3669822,NS.1272.003.D705.Qilalugene-P5_detailed.log,446348,NS.1272.003
TTCAGA,S_20_00953,1021532,1346,269983,750203,NS.1272.003.D705.Qilalugene-P5_detailed.log,271329,NS.1272.003
ACCTAA,S_20_03585,18760458,17355,1327317,17415786,NS.1272.003.D705.Qilalugene-P5_detailed.log,1344672,NS.1272.003
GTACTT,S_20_03182,3893134,5881,385912,3501341,NS.1272.003.D705.Qilalugene-P5_detailed.log,391793,NS.1272.003
GAATTCA,S_20_00981,1128538,2196,171961,954381,NS.1272.003.D705.Qilalugene-P5_detailed.log,174157,NS.1272.003
ATTGGAT,S_20_03036,3821358,7121,447354,3366883,NS.1272.003.D705.Qilalugene-P5_detailed.log,454475,NS.1272.003
TCTGTGA,S_20_02373,5797436,852,514067,5282517,NS.1272.003.D705.Qilalugene-P5_detailed.log,514919,NS.1272.003
CGCGATAT,S_20_03037,3311334,1049,387763,2922522,NS.1272.003.D705.Qilalugene-P5_detailed.log,388812,NS.1272.003
GCTGTGGA,S_20_03089,796848,150,61299,735399,NS.1272.003.D705.Qilalugene-P5_detailed.log,61449,NS.1272.003
AACT,S_20_02634,11794632,256382,936289,10601961,NS.1272.003.D705.Qilalugene-P5_detailed.log,1192671,NS.1272.003
CGCTT,S_20_01095,662090,16969,167513,477608,NS.1272.003.D705.Qilalugene-P5_detailed.log,184482,NS.1272.003
ACCGT,S_20_00685,2176338,31825,337101,1807412,NS.1272.003.D705.Qilalugene-P5_detailed.log,368926,NS.1272.003
GGAAG,S_20_00726_rep,5273588,46311,378140,4849137,NS.1272.003.D705.Qilalugene-P5_detailed.log,424451,NS.1272.003
TAGGAA,S_20_01018_rep,15320602,12594,1155726,14152282,NS.1272.003.D705.Qilalugene-P5_detailed.log,1168320,NS.1272.003
ATATGT,S_20_00948,2025034,21701,458786,1544547,NS.1272.003.D705.Qilalugene-P5_detailed.log,480487,NS.1272.003
GTTGAA,S_20_01991,2692600,994,221492,2470114,NS.1272.003.D705.Qilalugene-P5_detailed.log,222486,NS.1272.003
GAACTTG,S_20_00917_rep,2349924,14867,212304,2122753,NS.1272.003.D705.Qilalugene-P5_detailed.log,227171,NS.1272.003
CATAAGT,S_20_03186,3796936,4017,446960,3345959,NS.1272.003.D705.Qilalugene-P5_detailed.log,450977,NS.1272.003
TGCTGGA,S_20_03618,6275044,710,425654,5848680,NS.1272.003.D705.Qilalugene-P5_detailed.log,426364,NS.1272.003
CGCCTTAT,S_20_01069,1348684,828,246007,1101849,NS.1272.003.D705.Qilalugene-P5_detailed.log,246835,NS.1272.003
GGATTGGT,S_20_00637,1206984,662,239028,967294,NS.1272.003.D705.Qilalugene-P5_detailed.log,239690,NS.1272.003
GCGT,S_20_01062,3156760,108859,260830,2787071,NS.1272.003.D705.Qilalugene-P5_detailed.log,369689,NS.1272.003
TCACG,S_20_02262,3430488,34693,294928,3100867,NS.1272.003.D705.Qilalugene-P5_detailed.log,329621,NS.1272.003
GCTTA,S_20_03626,6806672,12867,501372,6292433,NS.1272.003.D705.Qilalugene-P5_detailed.log,514239,NS.1272.003
GTCAA,S_20_00678,1924454,24529,297916,1602009,NS.1272.003.D705.Qilalugene-P5_detailed.log,322445,NS.1272.003
GCTCTA,S_20_01017,2596700,2976,541671,2052053,NS.1272.003.D705.Qilalugene-P5_detailed.log,544647,NS.1272.003
ATCGTA,S_20_01010,2835584,7684,442531,2385369,NS.1272.003.D705.Qilalugene-P5_detailed.log,450215,NS.1272.003
TAACGA,S_20_03480,2230012,16495,256834,1956683,NS.1272.003.D705.Qilalugene-P5_detailed.log,273329,NS.1272.003
GGACCTA,S_20_01794,1651422,1366,132999,1517057,NS.1272.003.D705.Qilalugene-P5_detailed.log,134365,NS.1272.003
CGCTGAT,S_20_02239,7709982,4069,572448,7133465,NS.1272.003.D705.Qilalugene-P5_detailed.log,576517,NS.1272.003
ACGACTAG,S_20_01626,4502390,4530,375602,4122258,NS.1272.003.D705.Qilalugene-P5_detailed.log,380132,NS.1272.003
AACCGAGA,S_20_01090,1948872,2680,395435,1550757,NS.1272.003.D705.Qilalugene-P5_detailed.log,398115,NS.1272.003
GTGAGGGT,S_20_01086,3200638,2747,229235,2968656,NS.1272.003.D705.Qilalugene-P5_detailed.log,231982,NS.1272.003
CGAT,S_20_02966,4290238,147225,421796,3721217,NS.1272.003.D705.Qilalugene-P5_detailed.log,569021,NS.1272.003
CTAGG,S_20_01792,3733330,24179,228840,3480311,NS.1272.003.D705.Qilalugene-P5_detailed.log,253019,NS.1272.003
GGTGT,S_20_02591,7458168,21813,446919,6989436,NS.1272.003.D705.Qilalugene-P5_detailed.log,468732,NS.1272.003
TAATA,S_20_00642,2431888,60837,360597,2010454,NS.1272.003.D705.Qilalugene-P5_detailed.log,421434,NS.1272.003
CCACAA,S_20_00881,4138160,17874,526211,3594075,NS.1272.003.D705.Qilalugene-P5_detailed.log,544085,NS.1272.003
CATCGT,S_20_01059,2072848,10858,350935,1711055,NS.1272.003.D705.Qilalugene-P5_detailed.log,361793,NS.1272.003
TGGCTA,S_20_00959,3929606,5617,300335,3623654,NS.1272.003.D705.Qilalugene-P5_detailed.log,305952,NS.1272.003
GTCGATT,S_20_01089,567034,372,178707,387955,NS.1272.003.D705.Qilalugene-P5_detailed.log,179079,NS.1272.003
CGGTAGA,S_20_01709,2849266,674,273963,2574629,NS.1272.003.D705.Qilalugene-P5_detailed.log,274637,NS.1272.003
TAGCATGG,S_20_00636,2290918,3335,428160,1859423,NS.1272.003.D705.Qilalugene-P5_detailed.log,431495,NS.1272.003
ACAGGGA,S_20_03623,1894260,3020,155424,1735816,NS.1272.003.D705.Qilalugene-P5_detailed.log,158444,NS.1272.003
TATCGGGA,S_20_00852,2060700,2144,294035,1764521,NS.1272.003.D705.Qilalugene-P5_detailed.log,296179,NS.1272.003
GTAA,S_20_02964,3826248,120046,378719,3327483,NS.1272.003.D705.Qilalugene-P5_detailed.log,498765,NS.1272.003
ACAAA,S_20_00857,3115744,254128,251735,2609881,NS.1272.003.D705.Qilalugene-P5_detailed.log,505863,NS.1272.003
AGGAT,S_20_00918_rep,5594614,27302,420273,5147039,NS.1272.003.D705.Qilalugene-P5_detailed.log,447575,NS.1272.003
TACAT,S_20_03039,4722296,72235,444869,4205192,NS.1272.003.D705.Qilalugene-P5_detailed.log,517104,NS.1272.003
CTTCCA,S_20_01080,6557632,6703,436814,6114115,NS.1272.003.D705.Qilalugene-P5_detailed.log,443517,NS.1272.003
CGCGGT,S_20_03106,6567500,4532,391922,6171046,NS.1272.003.D705.Qilalugene-P5_detailed.log,396454,NS.1272.003
TATTTTT,S_20_00870,3011840,5400,269738,2736702,NS.1272.003.D705.Qilalugene-P5_detailed.log,275138,NS.1272.003
AACGCCT,S_20_03628,3692324,2589,246246,3443489,NS.1272.003.D705.Qilalugene-P5_detailed.log,248835,NS.1272.003
CTACGGA,S_20_01012,2677776,2683,428105,2246988,NS.1272.003.D705.Qilalugene-P5_detailed.log,430788,NS.1272.003
TAGGCCAT,S_20_00946,1198226,514,253449,944263,NS.1272.003.D705.Qilalugene-P5_detailed.log,253963,NS.1272.003
ACGTGGTA,S_20_00849,2133550,3281,206097,1924172,NS.1272.003.D705.Qilalugene-P5_detailed.log,209378,NS.1272.003
TTCCTGGA,S_20_02961,4260026,3563,278592,3977871,NS.1272.003.D705.Qilalugene-P5_detailed.log,282155,NS.1272.003
CTCG,S_20_00834,3204122,71479,309322,2823321,NS.1272.003.D706.Qilalugene-P6_detailed.log,380801,NS.1272.003
AGCG,S_20_01044,2687636,117191,336999,2233446,NS.1272.003.D706.Qilalugene-P6_detailed.log,454190,NS.1272.003
TTCTG,S_20_03616,12490634,15333,1394105,11081196,NS.1272.003.D706.Qilalugene-P6_detailed.log,1409438,NS.1272.003
ATTGA,S_20_01628,4616304,25851,682612,3907841,NS.1272.003.D706.Qilalugene-P6_detailed.log,708463,NS.1272.003
TCGTT,S_20_02285,7369140,10773,1222474,6135893,NS.1272.003.D706.Qilalugene-P6_detailed.log,1233247,NS.1272.003
GAGATA,S_20_00944,12117410,7321,1518175,10591914,NS.1272.003.D706.Qilalugene-P6_detailed.log,1525496,NS.1272.003
CTATTA,S_20_01803,3623176,8599,449748,3164829,NS.1272.003.D706.Qilalugene-P6_detailed.log,458347,NS.1272.003
CTTGCTT,S_20_01065,3077994,917,364165,2712912,NS.1272.003.D706.Qilalugene-P6_detailed.log,365082,NS.1272.003
AATATGG,S_20_00869,1695802,5007,401066,1289729,NS.1272.003.D706.Qilalugene-P6_detailed.log,406073,NS.1272.003
GCGGAAT,S_20_01058,1656002,1200,339758,1315044,NS.1272.003.D706.Qilalugene-P6_detailed.log,340958,NS.1272.003
TGCAAGGA,S_20_03655,5113170,849,653992,4458329,NS.1272.003.D706.Qilalugene-P6_detailed.log,654841,NS.1272.003
CCATGGGT,S_20_03100,4248866,5115,527170,3716581,NS.1272.003.D706.Qilalugene-P6_detailed.log,532285,NS.1272.003
TGCA,S_20_02249,6815416,71832,782232,5961352,NS.1272.003.D706.Qilalugene-P6_detailed.log,854064,NS.1272.003
GATG,S_20_02659,3943526,113704,566634,3263188,NS.1272.003.D706.Qilalugene-P6_detailed.log,680338,NS.1272.003
AGCCG,S_20_03034,11874254,17022,1670468,10186764,NS.1272.003.D706.Qilalugene-P6_detailed.log,1687490,NS.1272.003
CATCT,S_20_00643,3501150,45841,588198,2867111,NS.1272.003.D706.Qilalugene-P6_detailed.log,634039,NS.1272.003
GGTTGT,S_20_03033,10529102,7242,1257521,9264339,NS.1272.003.D706.Qilalugene-P6_detailed.log,1264763,NS.1272.003
ATGCCT,S_20_00816,12224874,6759,1930881,10287234,NS.1272.003.D706.Qilalugene-P6_detailed.log,1937640,NS.1272.003
GCCAGT,S_20_01094,2639028,5209,266458,2367361,NS.1272.003.D706.Qilalugene-P6_detailed.log,271667,NS.1272.003
ATGAAAG,S_20_02610,4302506,7492,452838,3842176,NS.1272.003.D706.Qilalugene-P6_detailed.log,460330,NS.1272.003
ACGTGTT,S_20_03345,7279926,6610,909173,6364143,NS.1272.003.D706.Qilalugene-P6_detailed.log,915783,NS.1272.003
TAGCGGA,S_20_02261,6068080,8161,628301,5431618,NS.1272.003.D706.Qilalugene-P6_detailed.log,636462,NS.1272.003
TGGTACGT,S_20_02383,3343164,1212,300956,3040996,NS.1272.003.D706.Qilalugene-P6_detailed.log,302168,NS.1272.003
CGCGGAGA,S_20_03631,4655886,854,492749,4162283,NS.1272.003.D706.Qilalugene-P6_detailed.log,493603,NS.1272.003
ACTA,S_20_00885,2300524,182941,399228,1718355,NS.1272.003.D706.Qilalugene-P6_detailed.log,582169,NS.1272.003
TCAG,S_20_00924,2716810,42713,398186,2275911,NS.1272.003.D706.Qilalugene-P6_detailed.log,440899,NS.1272.003
GTATT,S_20_03649,19220360,21029,2475795,16723536,NS.1272.003.D706.Qilalugene-P6_detailed.log,2496824,NS.1272.003
CCTAG,S_20_03591,4371924,7620,439580,3924724,NS.1272.003.D706.Qilalugene-P6_detailed.log,447200,NS.1272.003
CCACGT,S_20_00965,2658306,18304,497561,2142441,NS.1272.003.D706.Qilalugene-P6_detailed.log,515865,NS.1272.003
AGTGGA,S_20_00974,2666522,13128,799096,1854298,NS.1272.003.D706.Qilalugene-P6_detailed.log,812224,NS.1272.003
GGAAGA,S_20_00680,938106,1850,138850,797406,NS.1272.003.D706.Qilalugene-P6_detailed.log,140700,NS.1272.003
AAAAGTT,S_20_01053,2137152,29391,197717,1910044,NS.1272.003.D706.Qilalugene-P6_detailed.log,227108,NS.1272.003
ATTAATT,S_20_02180,12503986,11294,1439374,11053318,NS.1272.003.D706.Qilalugene-P6_detailed.log,1450668,NS.1272.003
TCGAAGA,S_20_02849,3098912,2958,276756,2819198,NS.1272.003.D706.Qilalugene-P6_detailed.log,279714,NS.1272.003
TCTCAGTG,S_20_01708,6593472,5107,670438,5917927,NS.1272.003.D706.Qilalugene-P6_detailed.log,675545,NS.1272.003
CGTGTGGT,S_20_01098_rep,1788422,2461,376970,1408991,NS.1272.003.D706.Qilalugene-P6_detailed.log,379431,NS.1272.003
CAGA,S_20_01764,3026330,159438,280158,2586734,NS.1272.003.D706.Qilalugene-P6_detailed.log,439596,NS.1272.003
TGCGA,S_20_02256,5973698,2915,575452,5395331,NS.1272.003.D706.Qilalugene-P6_detailed.log,578367,NS.1272.003
CTGTA,S_20_01631,9197830,13503,1216702,7967625,NS.1272.003.D706.Qilalugene-P6_detailed.log,1230205,NS.1272.003
GAGGA,S_20_01067,941214,25659,243341,672214,NS.1272.003.D706.Qilalugene-P6_detailed.log,269000,NS.1272.003
TTCAGA,S_20_02538,1749932,1425,532765,1215742,NS.1272.003.D706.Qilalugene-P6_detailed.log,534190,NS.1272.003
ACCTAA,S_20_00849_rep,15332536,10663,1532879,13788994,NS.1272.003.D706.Qilalugene-P6_detailed.log,1543542,NS.1272.003
GTACTT,S_20_01771,4211536,5804,384394,3821338,NS.1272.003.D706.Qilalugene-P6_detailed.log,390198,NS.1272.003
GAATTCA,S_20_00882,1048320,1822,203226,843272,NS.1272.003.D706.Qilalugene-P6_detailed.log,205048,NS.1272.003
ATTGGAT,S_20_03573,4868110,3284,572177,4292649,NS.1272.003.D706.Qilalugene-P6_detailed.log,575461,NS.1272.003
TCTGTGA,S_20_02386,3447140,493,423464,3023183,NS.1272.003.D706.Qilalugene-P6_detailed.log,423957,NS.1272.003
CGCGATAT,S_20_00979,1159404,642,225926,932836,NS.1272.003.D706.Qilalugene-P6_detailed.log,226568,NS.1272.003
GCTGTGGA,S_20_00686,5460976,792,620314,4839870,NS.1272.003.D706.Qilalugene-P6_detailed.log,621106,NS.1272.003
AACT,S_20_03607,4300510,235625,537361,3527524,NS.1272.003.D706.Qilalugene-P6_detailed.log,772986,NS.1272.003
CGCTT,S_20_01795,190600,13461,54780,122359,NS.1272.003.D706.Qilalugene-P6_detailed.log,68241,NS.1272.003
ACCGT,S_20_02957,21688594,41340,2483169,19164085,NS.1272.003.D706.Qilalugene-P6_detailed.log,2524509,NS.1272.003
GGAAG,S_20_01632,3258006,31290,399702,2827014,NS.1272.003.D706.Qilalugene-P6_detailed.log,430992,NS.1272.003
TAGGAA,S_20_00855_rep,3480458,4574,474444,3001440,NS.1272.003.D706.Qilalugene-P6_detailed.log,479018,NS.1272.003
ATATGT,S_20_00649_rep,4299300,23591,929660,3346049,NS.1272.003.D706.Qilalugene-P6_detailed.log,953251,NS.1272.003
GTTGAA,S_20_01787,1829898,723,193451,1635724,NS.1272.003.D706.Qilalugene-P6_detailed.log,194174,NS.1272.003
GAACTTG,S_20_01064,888466,20720,228788,638958,NS.1272.003.D706.Qilalugene-P6_detailed.log,249508,NS.1272.003
CATAAGT,S_20_01068,2254512,1665,503364,1749483,NS.1272.003.D706.Qilalugene-P6_detailed.log,505029,NS.1272.003
TGCTGGA,S_20_00818,2538320,315,317686,2220319,NS.1272.003.D706.Qilalugene-P6_detailed.log,318001,NS.1272.003
CGCCTTAT,S_20_00860,2713784,1380,342161,2370243,NS.1272.003.D706.Qilalugene-P6_detailed.log,343541,NS.1272.003
GGATTGGT,S_20_03339,8036692,4742,851107,7180843,NS.1272.003.D706.Qilalugene-P6_detailed.log,855849,NS.1272.003
GCGT,S_20_00817,3575948,129749,355132,3091067,NS.1272.003.D706.Qilalugene-P6_detailed.log,484881,NS.1272.003
TCACG,S_20_00975,2062702,17198,304508,1740996,NS.1272.003.D706.Qilalugene-P6_detailed.log,321706,NS.1272.003
GCTTA,S_20_02715,16534014,12115,1785671,14736228,NS.1272.003.D706.Qilalugene-P6_detailed.log,1797786,NS.1272.003
GTCAA,S_20_01021,4599022,15147,451475,4132400,NS.1272.003.D706.Qilalugene-P6_detailed.log,466622,NS.1272.003
GCTCTA,S_20_00626_rep,6044346,4754,625695,5413897,NS.1272.003.D706.Qilalugene-P6_detailed.log,630449,NS.1272.003
ATCGTA,S_20_03091,16145092,11919,2202092,13931081,NS.1272.003.D706.Qilalugene-P6_detailed.log,2214011,NS.1272.003
TAACGA,S_20_01072,2725596,18703,356349,2350544,NS.1272.003.D706.Qilalugene-P6_detailed.log,375052,NS.1272.003
GGACCTA,S_20_01777,1512664,1295,185134,1326235,NS.1272.003.D706.Qilalugene-P6_detailed.log,186429,NS.1272.003
CGCTGAT,S_20_02067,5376782,2166,784821,4589795,NS.1272.003.D706.Qilalugene-P6_detailed.log,786987,NS.1272.003
ACGACTAG,S_20_01985,2599270,2566,329475,2267229,NS.1272.003.D706.Qilalugene-P6_detailed.log,332041,NS.1272.003
AACCGAGA,S_20_03597,862892,1406,109496,751990,NS.1272.003.D706.Qilalugene-P6_detailed.log,110902,NS.1272.003
GTGAGGGT,S_20_01096,903336,612,297691,605033,NS.1272.003.D706.Qilalugene-P6_detailed.log,298303,NS.1272.003
CGAT,S_20_00971,1287898,168592,206347,912959,NS.1272.003.D706.Qilalugene-P6_detailed.log,374939,NS.1272.003
CTAGG,S_20_03207,2584730,19465,314086,2251179,NS.1272.003.D706.Qilalugene-P6_detailed.log,333551,NS.1272.003
GGTGT,S_20_00914,19356552,26611,1809288,17520653,NS.1272.003.D706.Qilalugene-P6_detailed.log,1835899,NS.1272.003
TAATA,S_20_03475,773054,38234,291525,443295,NS.1272.003.D706.Qilalugene-P6_detailed.log,329759,NS.1272.003
CCACAA,S_20_01618,6857058,14378,669631,6173049,NS.1272.003.D706.Qilalugene-P6_detailed.log,684009,NS.1272.003
CATCGT,S_20_01110,27168566,20167,2672727,24475672,NS.1272.003.D706.Qilalugene-P6_detailed.log,2692894,NS.1272.003
TGGCTA,S_20_01874,2748352,3798,272757,2471797,NS.1272.003.D706.Qilalugene-P6_detailed.log,276555,NS.1272.003
GTCGATT,S_20_00687,4527330,2008,509772,4015550,NS.1272.003.D706.Qilalugene-P6_detailed.log,511780,NS.1272.003
CGGTAGA,S_20_02390,5447562,957,509065,4937540,NS.1272.003.D706.Qilalugene-P6_detailed.log,510022,NS.1272.003
TAGCATGG,S_20_01096_rep,3462278,3867,445120,3013291,NS.1272.003.D706.Qilalugene-P6_detailed.log,448987,NS.1272.003
ACAGGGA,S_20_00855,3661848,5050,385975,3270823,NS.1272.003.D706.Qilalugene-P6_detailed.log,391025,NS.1272.003
TATCGGGA,S_20_00830,5748414,5669,709908,5032837,NS.1272.003.D706.Qilalugene-P6_detailed.log,715577,NS.1272.003
GTAA,S_20_03529,1498164,118756,240236,1139172,NS.1272.003.D706.Qilalugene-P6_detailed.log,358992,NS.1272.003
ACAAA,S_20_01783,2209654,163259,336444,1709951,NS.1272.003.D706.Qilalugene-P6_detailed.log,499703,NS.1272.003
AGGAT,S_20_00868,6257706,26475,1399869,4831362,NS.1272.003.D706.Qilalugene-P6_detailed.log,1426344,NS.1272.003
TACAT,S_20_02808,6499102,46100,657891,5795111,NS.1272.003.D706.Qilalugene-P6_detailed.log,703991,NS.1272.003
CTTCCA,S_20_01865,7061128,5698,739074,6316356,NS.1272.003.D706.Qilalugene-P6_detailed.log,744772,NS.1272.003
CGCGGT,S_20_00989,3450002,2134,762403,2685465,NS.1272.003.D706.Qilalugene-P6_detailed.log,764537,NS.1272.003
TATTTTT,S_20_02375,3217504,4532,398092,2814880,NS.1272.003.D706.Qilalugene-P6_detailed.log,402624,NS.1272.003
AACGCCT,S_20_02380,3260454,1772,306526,2952156,NS.1272.003.D706.Qilalugene-P6_detailed.log,308298,NS.1272.003
CTACGGA,S_20_01801,6818286,5650,916081,5896555,NS.1272.003.D706.Qilalugene-P6_detailed.log,921731,NS.1272.003
TAGGCCAT,S_20_03584,1047438,395,125695,921348,NS.1272.003.D706.Qilalugene-P6_detailed.log,126090,NS.1272.003
ACGTGGTA,S_20_02965,2703284,3880,335932,2363472,NS.1272.003.D706.Qilalugene-P6_detailed.log,339812,NS.1272.003
TTCCTGGA,S_20_02254,6214442,4752,694031,5515659,NS.1272.003.D706.Qilalugene-P6_detailed.log,698783,NS.1272.003
CTCG,S_20_01036,2701150,107914,248361,2344875,NS.1272.003.D707.Qilalugene-P7_detailed.log,356275,NS.1272.003
AGCG,S_20_02240,3042670,201601,253914,2587155,NS.1272.003.D707.Qilalugene-P7_detailed.log,455515,NS.1272.003
TTCTG,S_20_00861_rep,10278498,15415,787707,9475376,NS.1272.003.D707.Qilalugene-P7_detailed.log,803122,NS.1272.003
ATTGA,S_20_03026,11354422,65436,1061020,10227966,NS.1272.003.D707.Qilalugene-P7_detailed.log,1126456,NS.1272.003
TCGTT,S_20_00872,4458748,16746,605898,3836104,NS.1272.003.D707.Qilalugene-P7_detailed.log,622644,NS.1272.003
GAGATA,S_20_01083,11800232,11891,960301,10828040,NS.1272.003.D707.Qilalugene-P7_detailed.log,972192,NS.1272.003
CTATTA,S_20_03598,4709690,10887,484581,4214222,NS.1272.003.D707.Qilalugene-P7_detailed.log,495468,NS.1272.003
CTTGCTT,S_20_01042,5081362,1613,412909,4666840,NS.1272.003.D707.Qilalugene-P7_detailed.log,414522,NS.1272.003
AATATGG,S_20_00891,13162218,22419,1314496,11825303,NS.1272.003.D707.Qilalugene-P7_detailed.log,1336915,NS.1272.003
GCGGAAT,S_20_00650,3528778,2464,362940,3163374,NS.1272.003.D707.Qilalugene-P7_detailed.log,365404,NS.1272.003
TGCAAGGA,S_20_02299,2416888,751,423955,1992182,NS.1272.003.D707.Qilalugene-P7_detailed.log,424706,NS.1272.003
CCATGGGT,S_20_03482,7817972,7254,645277,7165441,NS.1272.003.D707.Qilalugene-P7_detailed.log,652531,NS.1272.003
TGCA,S_20_01622,6339944,63973,563219,5712752,NS.1272.003.D707.Qilalugene-P7_detailed.log,627192,NS.1272.003
GATG,S_20_00641,1822356,160040,240141,1422175,NS.1272.003.D707.Qilalugene-P7_detailed.log,400181,NS.1272.003
AGCCG,S_20_00814,4791760,24607,439034,4328119,NS.1272.003.D707.Qilalugene-P7_detailed.log,463641,NS.1272.003
CATCT,S_20_00862_rep,7970518,40830,755273,7174415,NS.1272.003.D707.Qilalugene-P7_detailed.log,796103,NS.1272.003
GGTTGT,S_20_01899,8410336,8043,845082,7557211,NS.1272.003.D707.Qilalugene-P7_detailed.log,853125,NS.1272.003
ATGCCT,S_20_03658,16866168,10350,1417387,15438431,NS.1272.003.D707.Qilalugene-P7_detailed.log,1427737,NS.1272.003
GCCAGT,S_20_03094,10352996,10326,843900,9498770,NS.1272.003.D707.Qilalugene-P7_detailed.log,854226,NS.1272.003
ATGAAAG,S_20_01038,4717292,7770,485253,4224269,NS.1272.003.D707.Qilalugene-P7_detailed.log,493023,NS.1272.003
ACGTGTT,S_20_00895,6120254,8019,901385,5210850,NS.1272.003.D707.Qilalugene-P7_detailed.log,909404,NS.1272.003
TAGCGGA,S_20_03181,4950744,5750,507893,4437101,NS.1272.003.D707.Qilalugene-P7_detailed.log,513643,NS.1272.003
TGGTACGT,S_20_00854,1215800,330,135617,1079853,NS.1272.003.D707.Qilalugene-P7_detailed.log,135947,NS.1272.003
CGCGGAGA,S_20_03613,4453474,753,408715,4044006,NS.1272.003.D707.Qilalugene-P7_detailed.log,409468,NS.1272.003
ACTA,S_20_00644,2960996,193657,416966,2350373,NS.1272.003.D707.Qilalugene-P7_detailed.log,610623,NS.1272.003
TCAG,S_20_03574,1260706,57650,120441,1082615,NS.1272.003.D707.Qilalugene-P7_detailed.log,178091,NS.1272.003
GTATT,S_20_00908,5932876,17822,614140,5300914,NS.1272.003.D707.Qilalugene-P7_detailed.log,631962,NS.1272.003
CCTAG,S_20_00982,2795352,13646,454418,2327288,NS.1272.003.D707.Qilalugene-P7_detailed.log,468064,NS.1272.003
CCACGT,S_20_00921,1969460,26108,164384,1778968,NS.1272.003.D707.Qilalugene-P7_detailed.log,190492,NS.1272.003
AGTGGA,S_20_01638,8651344,37065,770998,7843281,NS.1272.003.D707.Qilalugene-P7_detailed.log,808063,NS.1272.003
GGAAGA,S_20_01774,8789408,4421,709647,8075340,NS.1272.003.D707.Qilalugene-P7_detailed.log,714068,NS.1272.003
AAAAGTT,S_20_00654,7992902,39935,683002,7269965,NS.1272.003.D707.Qilalugene-P7_detailed.log,722937,NS.1272.003
ATTAATT,S_20_00954,7577728,9744,808606,6759378,NS.1272.003.D707.Qilalugene-P7_detailed.log,818350,NS.1272.003
TCGAAGA,S_20_03230,7432530,6684,651959,6773887,NS.1272.003.D707.Qilalugene-P7_detailed.log,658643,NS.1272.003
TCTCAGTG,S_20_00871,4965366,3729,787049,4174588,NS.1272.003.D707.Qilalugene-P7_detailed.log,790778,NS.1272.003
CGTGTGGT,S_20_01882,6352858,8087,545105,5799666,NS.1272.003.D707.Qilalugene-P7_detailed.log,553192,NS.1272.003
CAGA,S_20_01620,4282818,218775,402475,3661568,NS.1272.003.D707.Qilalugene-P7_detailed.log,621250,NS.1272.003
TGCGA,S_20_00647,1666670,4729,254972,1406969,NS.1272.003.D707.Qilalugene-P7_detailed.log,259701,NS.1272.003
CTGTA,S_20_02848,8833960,22694,737148,8074118,NS.1272.003.D707.Qilalugene-P7_detailed.log,759842,NS.1272.003
GAGGA,S_20_01095_rep,5287720,54783,593135,4639802,NS.1272.003.D707.Qilalugene-P7_detailed.log,647918,NS.1272.003
TTCAGA,S_20_00860_rep,174742,1219,22300,151223,NS.1272.003.D707.Qilalugene-P7_detailed.log,23519,NS.1272.003
ACCTAA,S_20_03528,10360874,9739,861169,9489966,NS.1272.003.D707.Qilalugene-P7_detailed.log,870908,NS.1272.003
GTACTT,S_20_01948,8531556,7892,1005061,7518603,NS.1272.003.D707.Qilalugene-P7_detailed.log,1012953,NS.1272.003
GAATTCA,S_20_00903,3256584,3288,313893,2939403,NS.1272.003.D707.Qilalugene-P7_detailed.log,317181,NS.1272.003
ATTGGAT,S_20_01784,13333744,13001,1000688,12320055,NS.1272.003.D707.Qilalugene-P7_detailed.log,1013689,NS.1272.003
TCTGTGA,S_20_03617,5321414,789,452526,4868099,NS.1272.003.D707.Qilalugene-P7_detailed.log,453315,NS.1272.003
CGCGATAT,S_20_01087,8950414,3174,867702,8079538,NS.1272.003.D707.Qilalugene-P7_detailed.log,870876,NS.1272.003
GCTGTGGA,S_20_00857_rep,8098008,1138,756642,7340228,NS.1272.003.D707.Qilalugene-P7_detailed.log,757780,NS.1272.003
AACT,S_20_03098,11575700,261669,833864,10480167,NS.1272.003.D707.Qilalugene-P7_detailed.log,1095533,NS.1272.003
CGCTT,S_20_00867,2317740,32231,224610,2060899,NS.1272.003.D707.Qilalugene-P7_detailed.log,256841,NS.1272.003
ACCGT,S_20_03180,2955622,32509,450829,2472284,NS.1272.003.D707.Qilalugene-P7_detailed.log,483338,NS.1272.003
GGAAG,S_20_03592,5233860,70528,460989,4702343,NS.1272.003.D707.Qilalugene-P7_detailed.log,531517,NS.1272.003
TAGGAA,S_20_02070,6115898,7452,567107,5541339,NS.1272.003.D707.Qilalugene-P7_detailed.log,574559,NS.1272.003
ATATGT,S_20_02869,3921976,28366,371138,3522472,NS.1272.003.D707.Qilalugene-P7_detailed.log,399504,NS.1272.003
GTTGAA,S_20_01766,10015124,2446,836018,9176660,NS.1272.003.D707.Qilalugene-P7_detailed.log,838464,NS.1272.003
GAACTTG,S_20_00878,2913264,18925,520612,2373727,NS.1272.003.D707.Qilalugene-P7_detailed.log,539537,NS.1272.003
CATAAGT,S_20_01786,4932872,4178,571142,4357552,NS.1272.003.D707.Qilalugene-P7_detailed.log,575320,NS.1272.003
TGCTGGA,S_20_03231,3943668,437,360294,3582937,NS.1272.003.D707.Qilalugene-P7_detailed.log,360731,NS.1272.003
CGCCTTAT,S_20_01639,8240408,3563,636709,7600136,NS.1272.003.D707.Qilalugene-P7_detailed.log,640272,NS.1272.003
GGATTGGT,S_20_03661,8688270,3191,952797,7732282,NS.1272.003.D707.Qilalugene-P7_detailed.log,955988,NS.1272.003
GCGT,S_20_01211,8282672,121625,755771,7405276,NS.1272.003.D707.Qilalugene-P7_detailed.log,877396,NS.1272.003
TCACG,S_20_02958,3884842,17616,334469,3532757,NS.1272.003.D707.Qilalugene-P7_detailed.log,352085,NS.1272.003
GCTTA,S_20_01788,10097324,17292,806956,9273076,NS.1272.003.D707.Qilalugene-P7_detailed.log,824248,NS.1272.003
GTCAA,S_20_01026,4177078,23248,631328,3522502,NS.1272.003.D707.Qilalugene-P7_detailed.log,654576,NS.1272.003
GCTCTA,S_20_01049,4307760,3897,448803,3855060,NS.1272.003.D707.Qilalugene-P7_detailed.log,452700,NS.1272.003
ATCGTA,S_20_03229,3164134,14333,412599,2737202,NS.1272.003.D707.Qilalugene-P7_detailed.log,426932,NS.1272.003
TAACGA,S_20_00651_rep,1129534,14719,217286,897529,NS.1272.003.D707.Qilalugene-P7_detailed.log,232005,NS.1272.003
GGACCTA,S_20_01061,4269682,2537,376558,3890587,NS.1272.003.D707.Qilalugene-P7_detailed.log,379095,NS.1272.003
CGCTGAT,S_20_03587,13963760,5166,1148943,12809651,NS.1272.003.D707.Qilalugene-P7_detailed.log,1154109,NS.1272.003
ACGACTAG,S_20_02633,4089832,4358,365722,3719752,NS.1272.003.D707.Qilalugene-P7_detailed.log,370080,NS.1272.003
AACCGAGA,S_20_00962,7135654,7961,726946,6400747,NS.1272.003.D707.Qilalugene-P7_detailed.log,734907,NS.1272.003
GTGAGGGT,S_20_00990,6436726,3315,501930,5931481,NS.1272.003.D707.Qilalugene-P7_detailed.log,505245,NS.1272.003
CGAT,S_20_03593,12610410,291420,1000797,11318193,NS.1272.003.D707.Qilalugene-P7_detailed.log,1292217,NS.1272.003
CTAGG,S_20_01783_rep,3534296,29954,301334,3203008,NS.1272.003.D707.Qilalugene-P7_detailed.log,331288,NS.1272.003
GGTGT,S_20_02242,9703656,29035,816254,8858367,NS.1272.003.D707.Qilalugene-P7_detailed.log,845289,NS.1272.003
TAATA,S_20_03203,9630334,57520,1124648,8448166,NS.1272.003.D707.Qilalugene-P7_detailed.log,1182168,NS.1272.003
CCACAA,S_20_01935,7274396,20328,647717,6606351,NS.1272.003.D707.Qilalugene-P7_detailed.log,668045,NS.1272.003
CATCGT,S_20_02716,11955958,15299,1008197,10932462,NS.1272.003.D707.Qilalugene-P7_detailed.log,1023496,NS.1272.003
TGGCTA,S_20_01024,1616516,2630,405422,1208464,NS.1272.003.D707.Qilalugene-P7_detailed.log,408052,NS.1272.003
GTCGATT,S_20_03102,10166230,4323,965619,9196288,NS.1272.003.D707.Qilalugene-P7_detailed.log,969942,NS.1272.003
CGGTAGA,S_20_03664,8611458,1547,578823,8031088,NS.1272.003.D707.Qilalugene-P7_detailed.log,580370,NS.1272.003
TAGCATGG,S_20_00951,1889284,2552,319270,1567462,NS.1272.003.D707.Qilalugene-P7_detailed.log,321822,NS.1272.003
ACAGGGA,S_20_00851,4210846,5944,492346,3712556,NS.1272.003.D707.Qilalugene-P7_detailed.log,498290,NS.1272.003
TATCGGGA,S_20_00963,872688,795,91363,780530,NS.1272.003.D707.Qilalugene-P7_detailed.log,92158,NS.1272.003
GTAA,S_20_01101,2137996,186731,341280,1609985,NS.1272.003.D707.Qilalugene-P7_detailed.log,528011,NS.1272.003
ACAAA,S_20_03031,1540454,186071,191961,1162422,NS.1272.003.D707.Qilalugene-P7_detailed.log,378032,NS.1272.003
AGGAT,S_20_01030,4093638,34621,621848,3437169,NS.1272.003.D707.Qilalugene-P7_detailed.log,656469,NS.1272.003
TACAT,S_20_01014,8820884,52956,892616,7875312,NS.1272.003.D707.Qilalugene-P7_detailed.log,945572,NS.1272.003
CTTCCA,S_20_01028,3507078,5712,536899,2964467,NS.1272.003.D707.Qilalugene-P7_detailed.log,542611,NS.1272.003
CGCGGT,S_20_03627,12256162,6725,1008696,11240741,NS.1272.003.D707.Qilalugene-P7_detailed.log,1015421,NS.1272.003
TATTTTT,S_20_00635,2431102,3432,409478,2018192,NS.1272.003.D707.Qilalugene-P7_detailed.log,412910,NS.1272.003
AACGCCT,S_20_01111,1160122,1505,327183,831434,NS.1272.003.D707.Qilalugene-P7_detailed.log,328688,NS.1272.003
CTACGGA,S_20_03197,3889352,3606,401462,3484284,NS.1272.003.D707.Qilalugene-P7_detailed.log,405068,NS.1272.003
TAGGCCAT,S_20_00898,2238856,927,294569,1943360,NS.1272.003.D707.Qilalugene-P7_detailed.log,295496,NS.1272.003
ACGTGGTA,S_20_02959,4294134,4650,404446,3885038,NS.1272.003.D707.Qilalugene-P7_detailed.log,409096,NS.1272.003
TTCCTGGA,S_20_01020,3643094,2709,351564,3288821,NS.1272.003.D707.Qilalugene-P7_detailed.log,354273,NS.1272.003
CTCG,S_20_02394,4900218,72607,226867,4600744,NS.1272.003.D708.Qilalugene-P8_detailed.log,299474,NS.1272.003
AGCG,S_20_03195,8445842,181259,324420,7940163,NS.1272.003.D708.Qilalugene-P8_detailed.log,505679,NS.1272.003
TTCTG,S_20_03601,9612692,17886,376371,9218435,NS.1272.003.D708.Qilalugene-P8_detailed.log,394257,NS.1272.003
ATTGA,S_20_01031,1562232,21160,161092,1379980,NS.1272.003.D708.Qilalugene-P8_detailed.log,182252,NS.1272.003
TCGTT,S_20_00683,2793508,10823,239856,2542829,NS.1272.003.D708.Qilalugene-P8_detailed.log,250679,NS.1272.003
GAGATA,S_20_01119,6962676,7263,346893,6608520,NS.1272.003.D708.Qilalugene-P8_detailed.log,354156,NS.1272.003
CTATTA,S_20_01019_rep,5362196,7094,406467,4948635,NS.1272.003.D708.Qilalugene-P8_detailed.log,413561,NS.1272.003
CTTGCTT,S_20_01944_rep,3991316,1084,277768,3712464,NS.1272.003.D708.Qilalugene-P8_detailed.log,278852,NS.1272.003
AATATGG,S_20_01029,2107846,5991,274564,1827291,NS.1272.003.D708.Qilalugene-P8_detailed.log,280555,NS.1272.003
GCGGAAT,S_20_03055,5503026,2154,232011,5268861,NS.1272.003.D708.Qilalugene-P8_detailed.log,234165,NS.1272.003
TGCAAGGA,S_20_01073,1168806,517,180267,988022,NS.1272.003.D708.Qilalugene-P8_detailed.log,180784,NS.1272.003
CCATGGGT,S_20_03119,9502478,10065,365493,9126920,NS.1272.003.D708.Qilalugene-P8_detailed.log,375558,NS.1272.003
TGCA,S_20_02365,5253586,78899,234447,4940240,NS.1272.003.D708.Qilalugene-P8_detailed.log,313346,NS.1272.003
GATG,S_20_00657,3525554,130461,149740,3245353,NS.1272.003.D708.Qilalugene-P8_detailed.log,280201,NS.1272.003
AGCCG,S_20_02109,5914518,19277,252273,5642968,NS.1272.003.D708.Qilalugene-P8_detailed.log,271550,NS.1272.003
CATCT,S_20_02069,2681188,28344,228572,2424272,NS.1272.003.D708.Qilalugene-P8_detailed.log,256916,NS.1272.003
GGTTGT,S_20_00852_rep,3749312,4312,182963,3562037,NS.1272.003.D708.Qilalugene-P8_detailed.log,187275,NS.1272.003
ATGCCT,S_20_00650_rep,1214126,1628,141009,1071489,NS.1272.003.D708.Qilalugene-P8_detailed.log,142637,NS.1272.003
GCCAGT,S_20_01074,7441358,8210,255611,7177537,NS.1272.003.D708.Qilalugene-P8_detailed.log,263821,NS.1272.003
ATGAAAG,S_20_00865,9042958,10729,370810,8661419,NS.1272.003.D708.Qilalugene-P8_detailed.log,381539,NS.1272.003
ACGTGTT,S_20_03632,2391334,3228,148846,2239260,NS.1272.003.D708.Qilalugene-P8_detailed.log,152074,NS.1272.003
TAGCGGA,S_20_01012_rep,6250982,8996,318016,5923970,NS.1272.003.D708.Qilalugene-P8_detailed.log,327012,NS.1272.003
TGGTACGT,S_20_01137,9396316,2737,394645,8998934,NS.1272.003.D708.Qilalugene-P8_detailed.log,397382,NS.1272.003
CGCGGAGA,S_20_01767,5323198,953,197265,5124980,NS.1272.003.D708.Qilalugene-P8_detailed.log,198218,NS.1272.003
ACTA,S_20_01060,1755634,143087,75630,1536917,NS.1272.003.D708.Qilalugene-P8_detailed.log,218717,NS.1272.003
TCAG,S_20_00968,1768990,51124,142860,1575006,NS.1272.003.D708.Qilalugene-P8_detailed.log,193984,NS.1272.003
GTATT,S_20_02917,6315430,14305,298890,6002235,NS.1272.003.D708.Qilalugene-P8_detailed.log,313195,NS.1272.003
CCTAG,S_20_02609,8947196,12239,322758,8612199,NS.1272.003.D708.Qilalugene-P8_detailed.log,334997,NS.1272.003
CCACGT,S_20_00961,3587190,40844,134745,3411601,NS.1272.003.D708.Qilalugene-P8_detailed.log,175589,NS.1272.003
AGTGGA,S_20_00853,5354560,3408,272489,5078663,NS.1272.003.D708.Qilalugene-P8_detailed.log,275897,NS.1272.003
GGAAGA,S_20_03614,4598838,1966,192204,4404668,NS.1272.003.D708.Qilalugene-P8_detailed.log,194170,NS.1272.003
AAAAGTT,S_20_01621,4665400,24070,256374,4384956,NS.1272.003.D708.Qilalugene-P8_detailed.log,280444,NS.1272.003
ATTAATT,S_20_02389,2296246,2066,128414,2165766,NS.1272.003.D708.Qilalugene-P8_detailed.log,130480,NS.1272.003
TCGAAGA,S_20_01624,11442346,9811,494244,10938291,NS.1272.003.D708.Qilalugene-P8_detailed.log,504055,NS.1272.003
TCTCAGTG,S_20_02636,9901732,6550,410033,9485149,NS.1272.003.D708.Qilalugene-P8_detailed.log,416583,NS.1272.003
CGTGTGGT,S_20_01066,2599344,2782,130857,2465705,NS.1272.003.D708.Qilalugene-P8_detailed.log,133639,NS.1272.003
CAGA,S_20_02110,3215094,132282,142892,2939920,NS.1272.003.D708.Qilalugene-P8_detailed.log,275174,NS.1272.003
TGCGA,S_20_00646_rep,4466434,4902,275470,4186062,NS.1272.003.D708.Qilalugene-P8_detailed.log,280372,NS.1272.003
CTGTA,S_20_01085,847810,15623,121626,710561,NS.1272.003.D708.Qilalugene-P8_detailed.log,137249,NS.1272.003
GAGGA,S_20_02252,5497894,52149,221400,5224345,NS.1272.003.D708.Qilalugene-P8_detailed.log,273549,NS.1272.003
TTCAGA,S_20_00824,1291020,1225,126609,1163186,NS.1272.003.D708.Qilalugene-P8_detailed.log,127834,NS.1272.003
ACCTAA,S_20_03478,8430400,8176,388693,8033531,NS.1272.003.D708.Qilalugene-P8_detailed.log,396869,NS.1272.003
GTACTT,S_20_01081,7690150,5734,328040,7356376,NS.1272.003.D708.Qilalugene-P8_detailed.log,333774,NS.1272.003
GAATTCA,S_20_03481,3348514,2901,297999,3047614,NS.1272.003.D708.Qilalugene-P8_detailed.log,300900,NS.1272.003
ATTGGAT,S_20_01097_rep,649402,3483,110793,535126,NS.1272.003.D708.Qilalugene-P8_detailed.log,114276,NS.1272.003
TCTGTGA,S_20_03590,4277936,572,175933,4101431,NS.1272.003.D708.Qilalugene-P8_detailed.log,176505,NS.1272.003
CGCGATAT,S_20_02913,7616154,2232,301618,7312304,NS.1272.003.D708.Qilalugene-P8_detailed.log,303850,NS.1272.003
GCTGTGGA,S_20_01939,7901126,1158,272819,7627149,NS.1272.003.D708.Qilalugene-P8_detailed.log,273977,NS.1272.003
AACT,S_20_01145,3574700,205229,216958,3152513,NS.1272.003.D708.Qilalugene-P8_detailed.log,422187,NS.1272.003
CGCTT,S_20_03575,9106388,21809,320660,8763919,NS.1272.003.D708.Qilalugene-P8_detailed.log,342469,NS.1272.003
ACCGT,S_20_01785,5788250,40273,235532,5512445,NS.1272.003.D708.Qilalugene-P8_detailed.log,275805,NS.1272.003
GGAAG,S_20_01635,2183452,35307,154474,1993671,NS.1272.003.D708.Qilalugene-P8_detailed.log,189781,NS.1272.003
TAGGAA,S_20_02068,3350566,7227,131261,3212078,NS.1272.003.D708.Qilalugene-P8_detailed.log,138488,NS.1272.003
ATATGT,S_20_00921_rep,3266012,23139,226495,3016378,NS.1272.003.D708.Qilalugene-P8_detailed.log,249634,NS.1272.003
GTTGAA,S_20_01093,6084760,1439,216335,5866986,NS.1272.003.D708.Qilalugene-P8_detailed.log,217774,NS.1272.003
GAACTTG,S_20_00835_rep,1466568,13836,197946,1254786,NS.1272.003.D708.Qilalugene-P8_detailed.log,211782,NS.1272.003
CATAAGT,S_20_00620,2295970,1813,190789,2103368,NS.1272.003.D708.Qilalugene-P8_detailed.log,192602,NS.1272.003
TGCTGGA,S_20_02173,5731750,649,254064,5477037,NS.1272.003.D708.Qilalugene-P8_detailed.log,254713,NS.1272.003
CGCCTTAT,S_20_00907,4216614,2050,294046,3920518,NS.1272.003.D708.Qilalugene-P8_detailed.log,296096,NS.1272.003
GGATTGGT,S_20_00969,2065546,1024,181730,1882792,NS.1272.003.D708.Qilalugene-P8_detailed.log,182754,NS.1272.003
GCGT,S_20_03476_rep,5280126,97326,209986,4972814,NS.1272.003.D708.Qilalugene-P8_detailed.log,307312,NS.1272.003
TCACG,S_20_01775,6773662,27518,312440,6433704,NS.1272.003.D708.Qilalugene-P8_detailed.log,339958,NS.1272.003
GCTTA,S_20_03028,7054060,14937,293651,6745472,NS.1272.003.D708.Qilalugene-P8_detailed.log,308588,NS.1272.003
GTCAA,S_20_01949,1534756,13271,167853,1353632,NS.1272.003.D708.Qilalugene-P8_detailed.log,181124,NS.1272.003
GCTCTA,S_20_00647_rep,3249658,3346,151099,3095213,NS.1272.003.D708.Qilalugene-P8_detailed.log,154445,NS.1272.003
ATCGTA,S_20_03027,10084732,7198,429694,9647840,NS.1272.003.D708.Qilalugene-P8_detailed.log,436892,NS.1272.003
TAACGA,S_20_01135,10105964,36875,400273,9668816,NS.1272.003.D708.Qilalugene-P8_detailed.log,437148,NS.1272.003
GGACCTA,S_20_01105,2301442,1419,171591,2128432,NS.1272.003.D708.Qilalugene-P8_detailed.log,173010,NS.1272.003
CGCTGAT,S_20_01079,4665008,2830,194448,4467730,NS.1272.003.D708.Qilalugene-P8_detailed.log,197278,NS.1272.003
ACGACTAG,S_20_01016,6176544,4867,255214,5916463,NS.1272.003.D708.Qilalugene-P8_detailed.log,260081,NS.1272.003
AACCGAGA,S_20_02387,7165372,7962,280267,6877143,NS.1272.003.D708.Qilalugene-P8_detailed.log,288229,NS.1272.003
GTGAGGGT,S_20_00659,677246,493,93095,583658,NS.1272.003.D708.Qilalugene-P8_detailed.log,93588,NS.1272.003
CGAT,S_20_01762,2261812,176736,144596,1940480,NS.1272.003.D708.Qilalugene-P8_detailed.log,321332,NS.1272.003
CTAGG,S_20_02809,5563348,29280,240211,5293857,NS.1272.003.D708.Qilalugene-P8_detailed.log,269491,NS.1272.003
GGTGT,S_20_03202,7294662,21583,347423,6925656,NS.1272.003.D708.Qilalugene-P8_detailed.log,369006,NS.1272.003
TAATA,S_20_00902,1105730,42082,55007,1008641,NS.1272.003.D708.Qilalugene-P8_detailed.log,97089,NS.1272.003
CCACAA,S_20_00930,2802762,10870,120436,2671456,NS.1272.003.D708.Qilalugene-P8_detailed.log,131306,NS.1272.003
CATCGT,S_20_01000,2250628,13173,181864,2055591,NS.1272.003.D708.Qilalugene-P8_detailed.log,195037,NS.1272.003
TGGCTA,S_20_01047,1652462,4432,79187,1568843,NS.1272.003.D708.Qilalugene-P8_detailed.log,83619,NS.1272.003
GTCGATT,S_20_03476,3097398,1013,130013,2966372,NS.1272.003.D708.Qilalugene-P8_detailed.log,131026,NS.1272.003
CGGTAGA,S_20_01051,5797180,962,203894,5592324,NS.1272.003.D708.Qilalugene-P8_detailed.log,204856,NS.1272.003
TAGCATGG,S_20_01112,3546676,3932,213967,3328777,NS.1272.003.D708.Qilalugene-P8_detailed.log,217899,NS.1272.003
ACAGGGA,S_20_00658,5764738,7561,215225,5541952,NS.1272.003.D708.Qilalugene-P8_detailed.log,222786,NS.1272.003
TATCGGGA,S_20_00851_rep,8697126,8917,388167,8300042,NS.1272.003.D708.Qilalugene-P8_detailed.log,397084,NS.1272.003
GTAA,S_20_01104,1089764,98621,96854,894289,NS.1272.003.D708.Qilalugene-P8_detailed.log,195475,NS.1272.003
ACAAA,S_20_01781,6246432,136585,242219,5867628,NS.1272.003.D708.Qilalugene-P8_detailed.log,378804,NS.1272.003
AGGAT,S_20_01021_rep,3987812,23483,227081,3737248,NS.1272.003.D708.Qilalugene-P8_detailed.log,250564,NS.1272.003
TACAT,S_20_01763,7628438,51093,323644,7253701,NS.1272.003.D708.Qilalugene-P8_detailed.log,374737,NS.1272.003
CTTCCA,S_20_00890,3744740,3637,126987,3614116,NS.1272.003.D708.Qilalugene-P8_detailed.log,130624,NS.1272.003
CGCGGT,S_20_01769,7662590,4842,248150,7409598,NS.1272.003.D708.Qilalugene-P8_detailed.log,252992,NS.1272.003
TATTTTT,S_20_02664,5162352,5634,193474,4963244,NS.1272.003.D708.Qilalugene-P8_detailed.log,199108,NS.1272.003
AACGCCT,S_20_00853_rep,2772960,1824,182301,2588835,NS.1272.003.D708.Qilalugene-P8_detailed.log,184125,NS.1272.003
CTACGGA,S_20_01139,3432918,3100,219027,3210791,NS.1272.003.D708.Qilalugene-P8_detailed.log,222127,NS.1272.003
TAGGCCAT,S_20_03665_rep,3063116,1204,201995,2859917,NS.1272.003.D708.Qilalugene-P8_detailed.log,203199,NS.1272.003
ACGTGGTA,S_20_03542,2161216,2112,152656,2006448,NS.1272.003.D708.Qilalugene-P8_detailed.log,154768,NS.1272.003
TTCCTGGA,S_20_00684,6778014,5441,262772,6509801,NS.1272.003.D708.Qilalugene-P8_detailed.log,268213,NS.1272.003
CTCG,S_20_02714,1943286,26142,285849,1631295,NS.1272.003.D709.Qilalugene-P9_detailed.log,311991,NS.1272.003
AGCG,S_20_01048,8978586,37548,974757,7966281,NS.1272.003.D709.Qilalugene-P9_detailed.log,1012305,NS.1272.003
TTCTG,S_20_02612,5550094,3903,791165,4755026,NS.1272.003.D709.Qilalugene-P9_detailed.log,795068,NS.1272.003
ATTGA,S_20_00991,2011446,9053,423416,1578977,NS.1272.003.D709.Qilalugene-P9_detailed.log,432469,NS.1272.003
TCGTT,S_20_00681,4929054,5891,632290,4290873,NS.1272.003.D709.Qilalugene-P9_detailed.log,638181,NS.1272.003
GAGATA,S_20_01866,8976940,4275,1160274,7812391,NS.1272.003.D709.Qilalugene-P9_detailed.log,1164549,NS.1272.003
TGCA,S_20_01134,4054158,29858,404209,3620091,NS.1272.003.D709.Qilalugene-P9_detailed.log,434067,NS.1272.003
GATG,S_20_00977,6373172,46676,892827,5433669,NS.1272.003.D709.Qilalugene-P9_detailed.log,939503,NS.1272.003
AGCCG,S_20_02391,8980082,7083,985180,7987819,NS.1272.003.D709.Qilalugene-P9_detailed.log,992263,NS.1272.003
CATCT,S_20_03508,7614002,22893,998878,6592231,NS.1272.003.D709.Qilalugene-P9_detailed.log,1021771,NS.1272.003
GGTTGT,S_20_00822,4061158,1905,698139,3361114,NS.1272.003.D709.Qilalugene-P9_detailed.log,700044,NS.1272.003
ATGCCT,S_20_03229_rep,2650652,1582,437627,2211443,NS.1272.003.D709.Qilalugene-P9_detailed.log,439209,NS.1272.003
ACTA,S_20_03185,3065360,66032,662758,2336570,NS.1272.003.D709.Qilalugene-P9_detailed.log,728790,NS.1272.003
TCAG,S_20_03606,2529244,26296,329961,2172987,NS.1272.003.D709.Qilalugene-P9_detailed.log,356257,NS.1272.003
GTATT,S_20_01765,12300494,13327,1290093,10997074,NS.1272.003.D709.Qilalugene-P9_detailed.log,1303420,NS.1272.003
CCTAG,S_20_01864,7978736,2634,857087,7119015,NS.1272.003.D709.Qilalugene-P9_detailed.log,859721,NS.1272.003
CCACGT,S_20_01045,1484674,30077,191471,1263126,NS.1272.003.D709.Qilalugene-P9_detailed.log,221548,NS.1272.003
AGTGGA,S_20_00835_rep_1,1574890,4102,436230,1134558,NS.1272.003.D709.Qilalugene-P9_detailed.log,440332,NS.1272.003
CAGA,S_20_02916,4461992,83304,516504,3862184,NS.1272.003.D709.Qilalugene-P9_detailed.log,599808,NS.1272.003
TGCGA,S_20_03662,11661916,1662,1380134,10280120,NS.1272.003.D709.Qilalugene-P9_detailed.log,1381796,NS.1272.003
CTGTA,S_20_00892,5441074,3871,886177,4551026,NS.1272.003.D709.Qilalugene-P9_detailed.log,890048,NS.1272.003
GAGGA,S_20_01001,2951332,13144,740219,2197969,NS.1272.003.D709.Qilalugene-P9_detailed.log,753363,NS.1272.003
TTCAGA,S_20_00928,3743468,1167,492870,3249431,NS.1272.003.D709.Qilalugene-P9_detailed.log,494037,NS.1272.003
AACT,S_20_01623,8752640,75345,919933,7757362,NS.1272.003.D709.Qilalugene-P9_detailed.log,995278,NS.1272.003
CGCTT,S_20_00916_rep,6839896,8556,865984,5965356,NS.1272.003.D709.Qilalugene-P9_detailed.log,874540,NS.1272.003
ACCGT,S_20_00894,2110252,20842,542362,1547048,NS.1272.003.D709.Qilalugene-P9_detailed.log,563204,NS.1272.003
GGAAG,S_20_01103,7242620,16260,1054559,6171801,NS.1272.003.D709.Qilalugene-P9_detailed.log,1070819,NS.1272.003
TAGGAA,S_20_01003,2865030,1713,667944,2195373,NS.1272.003.D709.Qilalugene-P9_detailed.log,669657,NS.1272.003
GCGT,S_20_00960,3671142,56173,673613,2941356,NS.1272.003.D709.Qilalugene-P9_detailed.log,729786,NS.1272.003
TCACG,S_20_02727,11010684,13798,1467453,9529433,NS.1272.003.D709.Qilalugene-P9_detailed.log,1481251,NS.1272.003
GCTTA,S_20_00854_rep,9520638,3482,1380323,8136833,NS.1272.003.D709.Qilalugene-P9_detailed.log,1383805,NS.1272.003
GTCAA,S_20_01136,11605358,8680,1394079,10202599,NS.1272.003.D709.Qilalugene-P9_detailed.log,1402759,NS.1272.003
GCTCTA,S_20_00929,7239194,3708,894182,6341304,NS.1272.003.D709.Qilalugene-P9_detailed.log,897890,NS.1272.003
CGAT,S_20_01106,2344972,69329,455675,1819968,NS.1272.003.D709.Qilalugene-P9_detailed.log,525004,NS.1272.003
CTAGG,S_20_01933,9440382,18558,1073794,8348030,NS.1272.003.D709.Qilalugene-P9_detailed.log,1092352,NS.1272.003
GGTGT,S_20_03084,13314508,17590,1617616,11679302,NS.1272.003.D709.Qilalugene-P9_detailed.log,1635206,NS.1272.003
TAATA,S_20_02083,1817788,18892,309380,1489516,NS.1272.003.D709.Qilalugene-P9_detailed.log,328272,NS.1272.003
CCACAA,S_20_01063,11358044,11495,1211570,10134979,NS.1272.003.D709.Qilalugene-P9_detailed.log,1223065,NS.1272.003
GTAA,S_20_02393,5713174,74137,740550,4898487,NS.1272.003.D709.Qilalugene-P9_detailed.log,814687,NS.1272.003
ACAAA,S_20_03663,10836098,71422,1388810,9375866,NS.1272.003.D709.Qilalugene-P9_detailed.log,1460232,NS.1272.003
AGGAT,S_20_01091,2023904,14475,569158,1440271,NS.1272.003.D709.Qilalugene-P9_detailed.log,583633,NS.1272.003
TACAT,S_20_00927,5692310,22996,847505,4821809,NS.1272.003.D709.Qilalugene-P9_detailed.log,870501,NS.1272.003
CTTCCA,S_20_00897,2864074,1817,723043,2139214,NS.1272.003.D709.Qilalugene-P9_detailed.log,724860,NS.1272.003
